,Date,File Name,Module,Commits,Added Lines,Removed Lines,Churn
0,2021-05-10 15:04:31-04:00,test_utils.py,nova\tests,251e601a4d86b487723b5297abf38b967def3d5e,3,3,6
1,2021-05-10 19:18:30+00:00,__init__.py,nova\tests,8b647f1b3f56879be221b3925570790a1e0e77f8,0,0,0
2,2021-05-10 19:18:30+00:00,test_rbd.py,nova\tests,8b647f1b3f56879be221b3925570790a1e0e77f8,1,1,2
3,2021-05-11 17:28:56+02:00,rbd_utils.py,nova\storage,86af7feed06f08ddb3ef65122089216708d53a06,8,1,9
4,2021-05-11 17:28:56+02:00,test_rbd.py,nova\tests,86af7feed06f08ddb3ef65122089216708d53a06,6,0,6
5,2021-05-12 10:50:52+08:00,common.py,nova\cmd,150b9182512fa0a4f157586e040a7f67c1851005,2,2,4
6,2021-05-12 10:50:52+08:00,neutron.py,nova\network,150b9182512fa0a4f157586e040a7f67c1851005,2,1,3
7,2021-05-12 10:50:52+08:00,test.py,nova,150b9182512fa0a4f157586e040a7f67c1851005,3,3,6
8,2021-05-12 10:50:52+08:00,test_objects.py,nova\tests,150b9182512fa0a4f157586e040a7f67c1851005,3,2,5
9,2021-05-12 10:50:52+08:00,test_imagebackend.py,nova\tests,150b9182512fa0a4f157586e040a7f67c1851005,5,3,8
10,2021-05-12 10:50:52+08:00,utils.py,nova,150b9182512fa0a4f157586e040a7f67c1851005,1,7,8
11,2021-05-12 11:30:41+01:00,__init__.py,nova\tests,d726ef51ec15509d7ee570b3d220e2e43d37c8f4,13,0,13
12,2021-05-12 11:30:41+01:00,nova.py,nova\tests,d726ef51ec15509d7ee570b3d220e2e43d37c8f4,0,0,0
13,2021-05-12 11:30:41+01:00,test.py,nova,2e53c8265371b0eaa5e41f80e3b09fc72766cf13,1,2,3
14,2021-05-12 11:30:41+01:00,__init__.py,nova\tests,2e53c8265371b0eaa5e41f80e3b09fc72766cf13,1,0,1
15,2021-05-12 11:30:41+01:00,conf.py,nova\tests,2e53c8265371b0eaa5e41f80e3b09fc72766cf13,0,0,0
16,2021-05-12 11:30:41+01:00,test_requestlog.py,nova\tests,2e53c8265371b0eaa5e41f80e3b09fc72766cf13,4,5,9
17,2021-05-12 11:30:41+01:00,test_fixtures.py,nova\tests,2e53c8265371b0eaa5e41f80e3b09fc72766cf13,6,7,13
18,2021-05-12 16:32:43+01:00,test.py,nova,c269285568b2f4a76baf55d57ccd39ae202def19,1,2,3
19,2021-05-12 16:32:43+01:00,__init__.py,nova\tests,c269285568b2f4a76baf55d57ccd39ae202def19,8,1,9
20,2021-05-12 16:32:43+01:00,api_paste.py,nova\tests,c269285568b2f4a76baf55d57ccd39ae202def19,1,1,2
21,2021-05-12 16:32:43+01:00,cast_as_call.py,nova\tests,c269285568b2f4a76baf55d57ccd39ae202def19,4,4,8
22,2021-05-12 16:32:43+01:00,policy.py,nova\tests,c269285568b2f4a76baf55d57ccd39ae202def19,1,1,2
23,2021-05-12 16:32:43+01:00,api_sample_base.py,nova\tests,c269285568b2f4a76baf55d57ccd39ae202def19,1,1,2
24,2021-05-12 16:32:43+01:00,integrated_helpers.py,nova\tests,c269285568b2f4a76baf55d57ccd39ae202def19,3,5,8
25,2021-05-12 16:32:43+01:00,test_numa_live_migration.py,nova\tests,c269285568b2f4a76baf55d57ccd39ae202def19,2,4,6
26,2021-05-12 16:32:43+01:00,test_numa_servers.py,nova\tests,c269285568b2f4a76baf55d57ccd39ae202def19,2,2,4
27,2021-05-12 16:32:43+01:00,test_pci_sriov_servers.py,nova\tests,c269285568b2f4a76baf55d57ccd39ae202def19,6,6,12
28,2021-05-12 16:32:43+01:00,test_bug_1522536.py,nova\tests,c269285568b2f4a76baf55d57ccd39ae202def19,2,4,6
29,2021-05-12 16:32:43+01:00,test_bug_1541691.py,nova\tests,c269285568b2f4a76baf55d57ccd39ae202def19,1,2,3
30,2021-05-12 16:32:43+01:00,test_bug_1548980.py,nova\tests,c269285568b2f4a76baf55d57ccd39ae202def19,2,4,6
31,2021-05-12 16:32:43+01:00,test_bug_1552888.py,nova\tests,c269285568b2f4a76baf55d57ccd39ae202def19,1,2,3
32,2021-05-12 16:32:43+01:00,test_bug_1554631.py,nova\tests,c269285568b2f4a76baf55d57ccd39ae202def19,3,3,6
33,2021-05-12 16:32:43+01:00,test_bug_1558866.py,nova\tests,c269285568b2f4a76baf55d57ccd39ae202def19,1,2,3
34,2021-05-12 16:32:43+01:00,test_bug_1595962.py,nova\tests,c269285568b2f4a76baf55d57ccd39ae202def19,2,4,6
35,2021-05-12 16:32:43+01:00,test_bug_1620248.py,nova\tests,c269285568b2f4a76baf55d57ccd39ae202def19,2,4,6
36,2021-05-12 16:32:43+01:00,test_bug_1670627.py,nova\tests,c269285568b2f4a76baf55d57ccd39ae202def19,2,4,6
37,2021-05-12 16:32:43+01:00,test_bug_1671648.py,nova\tests,c269285568b2f4a76baf55d57ccd39ae202def19,2,4,6
38,2021-05-12 16:32:43+01:00,test_bug_1675570.py,nova\tests,c269285568b2f4a76baf55d57ccd39ae202def19,2,4,6
39,2021-05-12 16:32:43+01:00,test_bug_1679750.py,nova\tests,c269285568b2f4a76baf55d57ccd39ae202def19,1,2,3
40,2021-05-12 16:32:43+01:00,test_bug_1682693.py,nova\tests,c269285568b2f4a76baf55d57ccd39ae202def19,1,2,3
41,2021-05-12 16:32:43+01:00,test_bug_1689692.py,nova\tests,c269285568b2f4a76baf55d57ccd39ae202def19,5,6,11
42,2021-05-12 16:32:43+01:00,test_bug_1702454.py,nova\tests,c269285568b2f4a76baf55d57ccd39ae202def19,5,6,11
43,2021-05-12 16:32:43+01:00,test_bug_1713783.py,nova\tests,c269285568b2f4a76baf55d57ccd39ae202def19,1,2,3
44,2021-05-12 16:32:43+01:00,test_bug_1718455.py,nova\tests,c269285568b2f4a76baf55d57ccd39ae202def19,1,2,3
45,2021-05-12 16:32:43+01:00,test_bug_1718512.py,nova\tests,c269285568b2f4a76baf55d57ccd39ae202def19,1,2,3
46,2021-05-12 16:32:43+01:00,test_bug_1719730.py,nova\tests,c269285568b2f4a76baf55d57ccd39ae202def19,1,2,3
47,2021-05-12 16:32:43+01:00,test_bug_1735407.py,nova\tests,c269285568b2f4a76baf55d57ccd39ae202def19,1,2,3
48,2021-05-12 16:32:43+01:00,test_bug_1741307.py,nova\tests,c269285568b2f4a76baf55d57ccd39ae202def19,1,2,3
49,2021-05-12 16:32:43+01:00,test_bug_1746483.py,nova\tests,c269285568b2f4a76baf55d57ccd39ae202def19,1,2,3
50,2021-05-12 16:32:43+01:00,test_bug_1764556.py,nova\tests,c269285568b2f4a76baf55d57ccd39ae202def19,1,2,3
51,2021-05-12 16:32:43+01:00,test_bug_1764883.py,nova\tests,c269285568b2f4a76baf55d57ccd39ae202def19,1,2,3
52,2021-05-12 16:32:43+01:00,test_bug_1780373.py,nova\tests,c269285568b2f4a76baf55d57ccd39ae202def19,1,2,3
53,2021-05-12 16:32:43+01:00,test_bug_1781286.py,nova\tests,c269285568b2f4a76baf55d57ccd39ae202def19,2,3,5
54,2021-05-12 16:32:43+01:00,test_bug_1781710.py,nova\tests,c269285568b2f4a76baf55d57ccd39ae202def19,1,2,3
55,2021-05-12 16:32:43+01:00,test_bug_1784353.py,nova\tests,c269285568b2f4a76baf55d57ccd39ae202def19,1,2,3
56,2021-05-12 16:32:43+01:00,test_bug_1797580.py,nova\tests,c269285568b2f4a76baf55d57ccd39ae202def19,1,2,3
57,2021-05-12 16:32:43+01:00,test_bug_1806064.py,nova\tests,c269285568b2f4a76baf55d57ccd39ae202def19,1,2,3
58,2021-05-12 16:32:43+01:00,test_bug_1815153.py,nova\tests,c269285568b2f4a76baf55d57ccd39ae202def19,1,2,3
59,2021-05-12 16:32:43+01:00,test_bug_1835822.py,nova\tests,c269285568b2f4a76baf55d57ccd39ae202def19,1,2,3
60,2021-05-12 16:32:43+01:00,test_bug_1852458.py,nova\tests,c269285568b2f4a76baf55d57ccd39ae202def19,1,2,3
61,2021-05-12 16:32:43+01:00,test_bug_1893284.py,nova\tests,c269285568b2f4a76baf55d57ccd39ae202def19,1,2,3
62,2021-05-12 16:32:43+01:00,test_bug_1902925.py,nova\tests,c269285568b2f4a76baf55d57ccd39ae202def19,3,2,5
63,2021-05-12 16:32:43+01:00,test_bug_1914777.py,nova\tests,c269285568b2f4a76baf55d57ccd39ae202def19,1,2,3
64,2021-05-12 16:32:43+01:00,test_aggregates.py,nova\tests,c269285568b2f4a76baf55d57ccd39ae202def19,1,2,3
65,2021-05-12 16:32:43+01:00,test_availability_zones.py,nova\tests,c269285568b2f4a76baf55d57ccd39ae202def19,3,3,6
66,2021-05-12 16:32:43+01:00,test_boot_from_volume.py,nova\tests,c269285568b2f4a76baf55d57ccd39ae202def19,1,2,3
67,2021-05-12 16:32:43+01:00,test_compute_mgr.py,nova\tests,c269285568b2f4a76baf55d57ccd39ae202def19,1,2,3
68,2021-05-12 16:32:43+01:00,test_cross_az_attach.py,nova\tests,c269285568b2f4a76baf55d57ccd39ae202def19,1,2,3
69,2021-05-12 16:32:43+01:00,test_cross_cell_migrate.py,nova\tests,c269285568b2f4a76baf55d57ccd39ae202def19,2,3,5
70,2021-05-12 16:32:43+01:00,test_external_networks.py,nova\tests,c269285568b2f4a76baf55d57ccd39ae202def19,1,2,3
71,2021-05-12 16:32:43+01:00,test_instance_actions.py,nova\tests,c269285568b2f4a76baf55d57ccd39ae202def19,1,2,3
72,2021-05-12 16:32:43+01:00,test_list_servers_ip_filter.py,nova\tests,c269285568b2f4a76baf55d57ccd39ae202def19,2,4,6
73,2021-05-12 16:32:43+01:00,test_nova_manage.py,nova\tests,c269285568b2f4a76baf55d57ccd39ae202def19,1,1,2
74,2021-05-12 16:32:43+01:00,test_policy.py,nova\tests,c269285568b2f4a76baf55d57ccd39ae202def19,1,2,3
75,2021-05-12 16:32:43+01:00,test_scheduler.py,nova\tests,c269285568b2f4a76baf55d57ccd39ae202def19,1,2,3
76,2021-05-12 16:32:43+01:00,test_server_faults.py,nova\tests,c269285568b2f4a76baf55d57ccd39ae202def19,1,2,3
77,2021-05-12 16:32:43+01:00,test_server_group.py,nova\tests,c269285568b2f4a76baf55d57ccd39ae202def19,2,3,5
78,2021-05-12 16:32:43+01:00,test_servers.py,nova\tests,c269285568b2f4a76baf55d57ccd39ae202def19,4,4,8
79,2021-05-12 16:32:43+01:00,test_service.py,nova\tests,c269285568b2f4a76baf55d57ccd39ae202def19,1,2,3
80,2021-05-12 16:32:43+01:00,test_flavor_manage.py,nova\tests,c269285568b2f4a76baf55d57ccd39ae202def19,1,2,3
81,2021-05-12 16:32:43+01:00,test_secgroup.py,nova\tests,c269285568b2f4a76baf55d57ccd39ae202def19,1,2,3
82,2021-05-12 16:32:43+01:00,test_servers.py,nova\tests,c269285568b2f4a76baf55d57ccd39ae202def19,4,5,9
83,2021-05-12 16:32:43+01:00,test_server_groups.py,nova\tests,c269285568b2f4a76baf55d57ccd39ae202def19,1,2,3
84,2021-05-12 16:32:43+01:00,test_policy.py,nova\tests,c269285568b2f4a76baf55d57ccd39ae202def19,2,2,4
85,2021-05-12 16:32:43+01:00,test_status.py,nova\tests,c269285568b2f4a76baf55d57ccd39ae202def19,1,2,3
86,2021-05-12 16:32:43+01:00,test_conductor.py,nova\tests,c269285568b2f4a76baf55d57ccd39ae202def19,18,19,37
87,2021-05-12 16:32:43+01:00,base.py,nova\tests,c269285568b2f4a76baf55d57ccd39ae202def19,3,2,5
88,2021-05-12 16:32:43+01:00,test_attach_interfaces.py,nova\tests,c269285568b2f4a76baf55d57ccd39ae202def19,2,2,4
89,2021-05-12 16:32:43+01:00,test_instance_actions.py,nova\tests,c269285568b2f4a76baf55d57ccd39ae202def19,2,2,4
90,2021-05-12 16:32:43+01:00,test_services.py,nova\tests,c269285568b2f4a76baf55d57ccd39ae202def19,2,2,4
91,2021-05-12 16:32:43+01:00,test_policy.py,nova\tests,c269285568b2f4a76baf55d57ccd39ae202def19,3,3,6
92,2021-05-13 14:28:33+01:00,__init__.py,nova\tests,212f89a61e16c05696e0ccc9f66bd6e5e6a91d4f,5,1,6
93,2021-05-13 14:28:33+01:00,cinder.py,nova\tests,212f89a61e16c05696e0ccc9f66bd6e5e6a91d4f,329,0,329
94,2021-05-13 14:28:33+01:00,cyborg.py,nova\tests,212f89a61e16c05696e0ccc9f66bd6e5e6a91d4f,184,0,184
95,2021-05-13 14:28:33+01:00,glance.py,nova\tests,212f89a61e16c05696e0ccc9f66bd6e5e6a91d4f,335,0,335
96,2021-05-13 14:28:33+01:00,neutron.py,nova\tests,212f89a61e16c05696e0ccc9f66bd6e5e6a91d4f,978,0,978
97,2021-05-13 14:28:33+01:00,nova.py,nova\tests,212f89a61e16c05696e0ccc9f66bd6e5e6a91d4f,0,1700,1700
98,2021-05-13 14:28:33+01:00,test_compute.py,nova\tests,212f89a61e16c05696e0ccc9f66bd6e5e6a91d4f,2,1,3
99,2021-05-13 14:28:33+01:00,test_conductor.py,nova\tests,212f89a61e16c05696e0ccc9f66bd6e5e6a91d4f,2,1,3
100,2021-05-14 12:52:06+01:00,test_bug_1928063.py,nova\tests,e1cc0ed978d40596d368ba19063fb5b51e96421e,69,0,69
101,2021-05-14 17:26:00+02:00,websocketproxy.py,nova\console,781612b33282ed298f742c85dab58a075c8b793e,23,0,23
102,2021-05-14 17:26:00+02:00,test_websocketproxy.py,nova\tests,781612b33282ed298f742c85dab58a075c8b793e,34,0,34
103,2021-05-14 17:26:00+02:00,console-proxy-reject-open-redirect-4ac0a7895acca7eb.yaml,releasenotes\notes,781612b33282ed298f742c85dab58a075c8b793e,19,0,19
104,2021-05-18 22:54:57+09:00,tox.ini,,74724b4964b6eb80a462458c7b04935ccae49710,2,2,4
105,2021-05-19 10:29:56+02:00,lower-constraints.txt,,0d84833e9688e0df97f3d24e06025e512bca3ce3,1,1,2
106,2021-05-19 10:29:56+02:00,libvirt.py,nova\conf,0d84833e9688e0df97f3d24e06025e512bca3ce3,1,1,2
107,2021-05-19 10:29:56+02:00,netconf.py,nova\conf,0d84833e9688e0df97f3d24e06025e512bca3ce3,1,1,2
108,2021-05-19 10:29:56+02:00,requirements.txt,,0d84833e9688e0df97f3d24e06025e512bca3ce3,1,1,2
109,2021-05-20 13:23:38+02:00,process.rst,doc\source,b28579a7b0dd744e83d1b01c777eef7654066694,68,0,68
110,2021-05-20 16:57:24+01:00,image_meta.py,nova\objects,9d037f7d199443da0f2c6c1755704e589d52e730,8,0,8
111,2021-05-20 16:57:24+01:00,test_server_actions.py,nova\tests,9d037f7d199443da0f2c6c1755704e589d52e730,24,16,40
112,2021-05-20 16:57:24+01:00,test_servers.py,nova\tests,9d037f7d199443da0f2c6c1755704e589d52e730,22,13,35
113,2021-05-20 16:57:24+01:00,fakes.py,nova\tests,9d037f7d199443da0f2c6c1755704e589d52e730,1,1,2
114,2021-05-20 16:57:24+01:00,test_api.py,nova\tests,9d037f7d199443da0f2c6c1755704e589d52e730,42,40,82
115,2021-05-20 16:57:24+01:00,test_compute.py,nova\tests,9d037f7d199443da0f2c6c1755704e589d52e730,13,10,23
116,2021-05-20 16:57:24+01:00,test_instance.py,nova\tests,9d037f7d199443da0f2c6c1755704e589d52e730,5,3,8
117,2021-05-20 16:57:24+01:00,test_driver.py,nova\tests,9d037f7d199443da0f2c6c1755704e589d52e730,22,21,43
118,2021-05-20 16:57:24+01:00,test_machine_type_utils.py,nova\tests,9d037f7d199443da0f2c6c1755704e589d52e730,2,1,3
119,2021-05-20 16:57:24+01:00,test_vif.py,nova\tests,9d037f7d199443da0f2c6c1755704e589d52e730,4,0,4
120,2021-05-20 16:57:24+01:00,test_configdrive.py,nova\tests,9d037f7d199443da0f2c6c1755704e589d52e730,5,0,5
121,2021-05-20 16:57:24+01:00,test_driver_api.py,nova\tests,9d037f7d199443da0f2c6c1755704e589d52e730,1,0,1
122,2021-05-20 17:33:35+01:00,libvirt-distro-support-matrix.rst,doc\source,d0b8028b5152875162b399c06a53e5b8eb46a5ee,23,3,26
123,2021-05-24 11:00:29+01:00,__init__.py,nova\tests,33be6d4b56e4b6c2cbb16b6b8d40821162fdfa5c,2,0,2
124,2021-05-24 11:00:29+01:00,imagebackend.py,nova\tests,33be6d4b56e4b6c2cbb16b6b8d40821162fdfa5c,19,18,37
125,2021-05-24 11:00:29+01:00,libvirt.py,nova\tests,33be6d4b56e4b6c2cbb16b6b8d40821162fdfa5c,3,3,6
126,2021-05-24 11:00:29+01:00,libvirt_data.py,nova\tests,33be6d4b56e4b6c2cbb16b6b8d40821162fdfa5c,0,0,0
127,2021-05-24 11:00:29+01:00,base.py,nova\tests,33be6d4b56e4b6c2cbb16b6b8d40821162fdfa5c,3,4,7
128,2021-05-24 11:00:29+01:00,integrated_helpers.py,nova\tests,33be6d4b56e4b6c2cbb16b6b8d40821162fdfa5c,2,2,4
129,2021-05-24 11:00:29+01:00,test_evacuate.py,nova\tests,33be6d4b56e4b6c2cbb16b6b8d40821162fdfa5c,2,2,4
130,2021-05-24 11:00:29+01:00,test_numa_live_migration.py,nova\tests,33be6d4b56e4b6c2cbb16b6b8d40821162fdfa5c,2,2,4
131,2021-05-24 11:00:29+01:00,test_numa_servers.py,nova\tests,33be6d4b56e4b6c2cbb16b6b8d40821162fdfa5c,1,1,2
132,2021-05-24 11:00:29+01:00,test_pci_sriov_servers.py,nova\tests,33be6d4b56e4b6c2cbb16b6b8d40821162fdfa5c,2,2,4
133,2021-05-24 11:00:29+01:00,test_report_cpu_traits.py,nova\tests,33be6d4b56e4b6c2cbb16b6b8d40821162fdfa5c,1,1,2
134,2021-05-24 11:00:29+01:00,test_reshape.py,nova\tests,33be6d4b56e4b6c2cbb16b6b8d40821162fdfa5c,1,1,2
135,2021-05-24 11:00:29+01:00,test_vgpu.py,nova\tests,33be6d4b56e4b6c2cbb16b6b8d40821162fdfa5c,1,1,2
136,2021-05-24 11:00:29+01:00,test_vpmem.py,nova\tests,33be6d4b56e4b6c2cbb16b6b8d40821162fdfa5c,3,3,6
137,2021-05-24 11:00:29+01:00,test_libvirt.py,nova\tests,33be6d4b56e4b6c2cbb16b6b8d40821162fdfa5c,3,2,5
138,2021-05-24 11:00:29+01:00,test_bug_1595962.py,nova\tests,33be6d4b56e4b6c2cbb16b6b8d40821162fdfa5c,2,2,4
139,2021-05-24 11:00:29+01:00,test_bug_1888395.py,nova\tests,33be6d4b56e4b6c2cbb16b6b8d40821162fdfa5c,2,2,4
140,2021-05-24 11:00:29+01:00,test_bug_1899649.py,nova\tests,33be6d4b56e4b6c2cbb16b6b8d40821162fdfa5c,1,1,2
141,2021-05-24 11:00:29+01:00,test_bug_1928063.py,nova\tests,33be6d4b56e4b6c2cbb16b6b8d40821162fdfa5c,1,1,2
142,2021-05-24 11:00:29+01:00,test_libvirt.py,nova\tests,33be6d4b56e4b6c2cbb16b6b8d40821162fdfa5c,1,1,2
143,2021-05-24 11:00:29+01:00,test_config.py,nova\tests,33be6d4b56e4b6c2cbb16b6b8d40821162fdfa5c,1,1,2
144,2021-05-24 11:00:29+01:00,test_designer.py,nova\tests,33be6d4b56e4b6c2cbb16b6b8d40821162fdfa5c,1,1,2
145,2021-05-24 11:00:29+01:00,test_driver.py,nova\tests,33be6d4b56e4b6c2cbb16b6b8d40821162fdfa5c,30,31,61
146,2021-05-24 11:00:29+01:00,test_guest.py,nova\tests,33be6d4b56e4b6c2cbb16b6b8d40821162fdfa5c,5,4,9
147,2021-05-24 11:00:29+01:00,test_host.py,nova\tests,33be6d4b56e4b6c2cbb16b6b8d40821162fdfa5c,6,5,11
148,2021-05-24 11:00:29+01:00,test_migration.py,nova\tests,33be6d4b56e4b6c2cbb16b6b8d40821162fdfa5c,3,2,5
149,2021-05-24 11:00:29+01:00,test_utils.py,nova\tests,33be6d4b56e4b6c2cbb16b6b8d40821162fdfa5c,5,6,11
150,2021-05-24 11:00:29+01:00,test_vif.py,nova\tests,33be6d4b56e4b6c2cbb16b6b8d40821162fdfa5c,3,2,5
151,2021-05-24 11:00:29+01:00,test_volume.py,nova\tests,33be6d4b56e4b6c2cbb16b6b8d40821162fdfa5c,3,3,6
152,2021-05-24 11:00:29+01:00,test_virt_drivers.py,nova\tests,33be6d4b56e4b6c2cbb16b6b8d40821162fdfa5c,4,7,11
153,2021-05-24 11:00:59+01:00,__init__.py,nova\tests,e2d25eb149b4439751394fa583bfa10ee94c0b2a,1,0,1
154,2021-05-24 11:00:59+01:00,os_brick.py,nova\tests,e2d25eb149b4439751394fa583bfa10ee94c0b2a,19,6,25
155,2021-05-24 11:00:59+01:00,test_numa_live_migration.py,nova\tests,e2d25eb149b4439751394fa583bfa10ee94c0b2a,3,4,7
156,2021-05-24 11:00:59+01:00,test_pci_sriov_servers.py,nova\tests,e2d25eb149b4439751394fa583bfa10ee94c0b2a,1,4,5
157,2021-05-24 11:00:59+01:00,test_bug_1888395.py,nova\tests,e2d25eb149b4439751394fa583bfa10ee94c0b2a,3,7,10
158,2021-05-24 11:00:59+01:00,test_virt_drivers.py,nova\tests,e2d25eb149b4439751394fa583bfa10ee94c0b2a,1,6,7
159,2021-05-24 11:00:59+01:00,__init__.py,nova\tests,696fbab9e1a96841b0acd1d5530b59e4c7878c00,1,1,2
160,2021-05-24 11:00:59+01:00,libvirt_imagebackend.py,nova\tests,696fbab9e1a96841b0acd1d5530b59e4c7878c00,1,1,2
161,2021-05-24 11:00:59+01:00,base.py,nova\tests,696fbab9e1a96841b0acd1d5530b59e4c7878c00,1,1,2
162,2021-05-24 11:00:59+01:00,test_vpmem.py,nova\tests,696fbab9e1a96841b0acd1d5530b59e4c7878c00,1,1,2
163,2021-05-24 11:00:59+01:00,test_driver.py,nova\tests,696fbab9e1a96841b0acd1d5530b59e4c7878c00,24,24,48
164,2021-05-24 11:00:59+01:00,test_virt_drivers.py,nova\tests,696fbab9e1a96841b0acd1d5530b59e4c7878c00,1,1,2
165,2021-05-24 11:00:59+01:00,__init__.py,nova\tests,f1f599d098c2dcb307bfab074060855c703a8288,1,0,1
166,2021-05-24 11:00:59+01:00,notifications.py,nova\tests,f1f599d098c2dcb307bfab074060855c703a8288,39,0,39
167,2021-05-24 11:00:59+01:00,test_cache_image.py,nova\tests,f1f599d098c2dcb307bfab074060855c703a8288,6,6,12
168,2021-05-24 11:00:59+01:00,test_init_host.py,nova\tests,f1f599d098c2dcb307bfab074060855c703a8288,1,2,3
169,2021-05-24 11:00:59+01:00,test_live_migration.py,nova\tests,f1f599d098c2dcb307bfab074060855c703a8288,0,3,3
170,2021-05-24 11:00:59+01:00,test_resource_tracker.py,nova\tests,f1f599d098c2dcb307bfab074060855c703a8288,0,3,3
171,2021-05-24 11:00:59+01:00,integrated_helpers.py,nova\tests,f1f599d098c2dcb307bfab074060855c703a8288,13,14,27
172,2021-05-24 11:00:59+01:00,test_evacuate.py,nova\tests,f1f599d098c2dcb307bfab074060855c703a8288,3,4,7
173,2021-05-24 11:00:59+01:00,test_numa_servers.py,nova\tests,f1f599d098c2dcb307bfab074060855c703a8288,0,4,4
174,2021-05-24 11:00:59+01:00,test_pci_sriov_servers.py,nova\tests,f1f599d098c2dcb307bfab074060855c703a8288,2,3,5
175,2021-05-24 11:00:59+01:00,notification_sample_base.py,nova\tests,f1f599d098c2dcb307bfab074060855c703a8288,14,15,29
176,2021-05-24 11:00:59+01:00,test_aggregate.py,nova\tests,f1f599d098c2dcb307bfab074060855c703a8288,27,28,55
177,2021-05-24 11:00:59+01:00,test_compute_task.py,nova\tests,f1f599d098c2dcb307bfab074060855c703a8288,11,12,23
178,2021-05-24 11:00:59+01:00,test_exception_notification.py,nova\tests,f1f599d098c2dcb307bfab074060855c703a8288,3,4,7
179,2021-05-24 11:00:59+01:00,test_flavor.py,nova\tests,f1f599d098c2dcb307bfab074060855c703a8288,6,7,13
180,2021-05-24 11:00:59+01:00,test_instance.py,nova\tests,f1f599d098c2dcb307bfab074060855c703a8288,208,209,417
181,2021-05-24 11:00:59+01:00,test_keypair.py,nova\tests,f1f599d098c2dcb307bfab074060855c703a8288,9,10,19
182,2021-05-24 11:00:59+01:00,test_libvirt.py,nova\tests,f1f599d098c2dcb307bfab074060855c703a8288,2,3,5
183,2021-05-24 11:00:59+01:00,test_metrics.py,nova\tests,f1f599d098c2dcb307bfab074060855c703a8288,2,3,5
184,2021-05-24 11:00:59+01:00,test_server_group.py,nova\tests,f1f599d098c2dcb307bfab074060855c703a8288,8,9,17
185,2021-05-24 11:00:59+01:00,test_service.py,nova\tests,f1f599d098c2dcb307bfab074060855c703a8288,1,2,3
186,2021-05-24 11:00:59+01:00,test_volume.py,nova\tests,f1f599d098c2dcb307bfab074060855c703a8288,5,6,11
187,2021-05-24 11:00:59+01:00,test_bug_1713783.py,nova\tests,f1f599d098c2dcb307bfab074060855c703a8288,2,2,4
188,2021-05-24 11:00:59+01:00,test_bug_1735407.py,nova\tests,f1f599d098c2dcb307bfab074060855c703a8288,4,5,9
189,2021-05-24 11:00:59+01:00,test_bug_1764883.py,nova\tests,f1f599d098c2dcb307bfab074060855c703a8288,0,3,3
190,2021-05-24 11:00:59+01:00,test_bug_1781286.py,nova\tests,f1f599d098c2dcb307bfab074060855c703a8288,6,7,13
191,2021-05-24 11:00:59+01:00,test_bug_1806515.py,nova\tests,f1f599d098c2dcb307bfab074060855c703a8288,0,3,3
192,2021-05-24 11:00:59+01:00,test_bug_1835822.py,nova\tests,f1f599d098c2dcb307bfab074060855c703a8288,2,3,5
193,2021-05-24 11:00:59+01:00,test_bug_1843090.py,nova\tests,f1f599d098c2dcb307bfab074060855c703a8288,0,3,3
194,2021-05-24 11:00:59+01:00,test_bug_1843708.py,nova\tests,f1f599d098c2dcb307bfab074060855c703a8288,1,2,3
195,2021-05-24 11:00:59+01:00,test_bug_1862633.py,nova\tests,f1f599d098c2dcb307bfab074060855c703a8288,3,4,7
196,2021-05-24 11:00:59+01:00,test_cold_migrate.py,nova\tests,f1f599d098c2dcb307bfab074060855c703a8288,1,2,3
197,2021-05-24 11:00:59+01:00,test_cross_cell_migrate.py,nova\tests,f1f599d098c2dcb307bfab074060855c703a8288,18,19,37
198,2021-05-24 11:00:59+01:00,test_server_external_events.py,nova\tests,f1f599d098c2dcb307bfab074060855c703a8288,4,5,9
199,2021-05-24 11:00:59+01:00,test_servers.py,nova\tests,f1f599d098c2dcb307bfab074060855c703a8288,16,24,40
200,2021-05-24 11:00:59+01:00,test_compute.py,nova\tests,f1f599d098c2dcb307bfab074060855c703a8288,1,2,3
201,2021-05-24 11:00:59+01:00,test_compute_mgr.py,nova\tests,f1f599d098c2dcb307bfab074060855c703a8288,17,18,35
202,2021-05-24 11:00:59+01:00,test_compute_utils.py,nova\tests,f1f599d098c2dcb307bfab074060855c703a8288,27,28,55
203,2021-05-24 11:00:59+01:00,test_host_api.py,nova\tests,f1f599d098c2dcb307bfab074060855c703a8288,1,2,3
204,2021-05-24 11:00:59+01:00,test_resource_tracker.py,nova\tests,f1f599d098c2dcb307bfab074060855c703a8288,2,2,4
205,2021-05-24 11:00:59+01:00,test_conductor.py,nova\tests,f1f599d098c2dcb307bfab074060855c703a8288,1,2,3
206,2021-05-24 11:00:59+01:00,test_objects.py,nova\tests,f1f599d098c2dcb307bfab074060855c703a8288,1,3,4
207,2021-05-24 11:00:59+01:00,test_exception_wrapper.py,nova\tests,f1f599d098c2dcb307bfab074060855c703a8288,8,7,15
208,2021-05-24 11:00:59+01:00,test_notifications.py,nova\tests,f1f599d098c2dcb307bfab074060855c703a8288,29,29,58
209,2021-05-24 11:00:59+01:00,notifications.py,nova\tests,b14f6ba62e4feed98e7293a6d67dbbc321994c7d,4,0,4
210,2021-05-24 11:00:59+01:00,test_bug_1713783.py,nova\tests,b14f6ba62e4feed98e7293a6d67dbbc321994c7d,2,3,5
211,2021-05-24 11:00:59+01:00,test_bug_1837955.py,nova\tests,b14f6ba62e4feed98e7293a6d67dbbc321994c7d,2,3,5
212,2021-05-24 11:00:59+01:00,test_compute.py,nova\tests,b14f6ba62e4feed98e7293a6d67dbbc321994c7d,135,138,273
213,2021-05-24 11:00:59+01:00,test_compute_mgr.py,nova\tests,b14f6ba62e4feed98e7293a6d67dbbc321994c7d,5,6,11
214,2021-05-24 11:00:59+01:00,test_compute_utils.py,nova\tests,b14f6ba62e4feed98e7293a6d67dbbc321994c7d,11,12,23
215,2021-05-24 11:00:59+01:00,test_host_api.py,nova\tests,b14f6ba62e4feed98e7293a6d67dbbc321994c7d,11,14,25
216,2021-05-24 11:00:59+01:00,test_keypairs.py,nova\tests,b14f6ba62e4feed98e7293a6d67dbbc321994c7d,3,4,7
217,2021-05-24 11:00:59+01:00,test_resource_tracker.py,nova\tests,b14f6ba62e4feed98e7293a6d67dbbc321994c7d,3,4,7
218,2021-05-24 11:00:59+01:00,test_conductor.py,nova\tests,b14f6ba62e4feed98e7293a6d67dbbc321994c7d,5,6,11
219,2021-05-24 11:00:59+01:00,test_aggregate.py,nova\tests,b14f6ba62e4feed98e7293a6d67dbbc321994c7d,3,5,8
220,2021-05-24 11:00:59+01:00,test_objects.py,nova\tests,b14f6ba62e4feed98e7293a6d67dbbc321994c7d,2,1,3
221,2021-05-24 11:00:59+01:00,test_exception_wrapper.py,nova\tests,b14f6ba62e4feed98e7293a6d67dbbc321994c7d,3,4,7
222,2021-05-24 11:00:59+01:00,test_notifications.py,nova\tests,b14f6ba62e4feed98e7293a6d67dbbc321994c7d,23,24,47
223,2021-05-25 16:45:51+01:00,networking.rst,doc\source,472db13aaf140a3cd59877292b9518d7fb665d94,2,6,8
224,2021-05-26 17:26:05+01:00,libvirt_data.py,nova\tests,740e6f09bf5a3e5ab3c6dd6d412dd1fe33f81d9f,3,1,4
225,2021-05-26 17:26:05+01:00,test_driver.py,nova\tests,740e6f09bf5a3e5ab3c6dd6d412dd1fe33f81d9f,14,6,20
226,2021-05-26 17:26:05+01:00,config.py,nova\virt,740e6f09bf5a3e5ab3c6dd6d412dd1fe33f81d9f,6,0,6
227,2021-05-26 17:26:05+01:00,driver.py,nova\virt,740e6f09bf5a3e5ab3c6dd6d412dd1fe33f81d9f,9,0,9
228,2021-05-26 17:26:05+01:00,libvirt-vmcoreinfo-3be69e21dfe7dbd2.yaml,releasenotes\notes,740e6f09bf5a3e5ab3c6dd6d412dd1fe33f81d9f,10,0,10
229,2021-05-26 19:35:29+01:00,.zuul.yaml,,d5ed968826895d362f4f2aa21decfdebb9b1fd84,3,1,4
230,2021-05-26 19:35:31+01:00,test_bug_1928063.py,nova\tests,e98994027f0af0b22277bcfaed4ab6e6f4a2c74e,2,10,12
231,2021-05-26 19:35:31+01:00,test_hardware.py,nova\tests,e98994027f0af0b22277bcfaed4ab6e6f4a2c74e,4,4,8
232,2021-05-26 19:35:31+01:00,hardware.py,nova\virt,e98994027f0af0b22277bcfaed4ab6e6f4a2c74e,1,1,2
233,2021-05-28 00:27:03+00:00,neutron.py,nova\network,56eb253e9febccf721df6bca4eb851ad26cb70a6,1,0,1
234,2021-05-28 00:27:03+00:00,test_neutron.py,nova\tests,56eb253e9febccf721df6bca4eb851ad26cb70a6,2,0,2
235,2021-05-28 11:52:27+00:00,test_neutron.py,nova\tests,17ac1a40cbc7773e5f86e2f5ef2e14767a14e4c8,76,0,76
236,2021-05-28 14:26:56+02:00,request_spec.py,nova\objects,5c50a45a1e5b66e6ef97192bbaec6fdd54f9c2a4,5,2,7
237,2021-05-28 14:26:56+02:00,test_request_spec.py,nova\tests,5c50a45a1e5b66e6ef97192bbaec6fdd54f9c2a4,12,1,13
238,2021-05-31 10:43:49+02:00,api.rst,doc\source,fc3838a9b3700b4b83d6d34ae86b6ab057c2dab3,1,1,2
239,2021-05-31 10:43:49+02:00,deprecate-image-download-ext-point-cd5809e11bbd09d3.yaml,releasenotes\notes,fc3838a9b3700b4b83d6d34ae86b6ab057c2dab3,1,1,2
240,2021-05-31 10:43:49+02:00,deprecate-xen-driver-train-bd57a16fa51ab679.yaml,releasenotes\notes,fc3838a9b3700b4b83d6d34ae86b6ab057c2dab3,1,1,2
241,2021-05-31 10:43:49+02:00,remove-caching-scheduler-cfe0985b5a58bef4.yaml,releasenotes\notes,fc3838a9b3700b4b83d6d34ae86b6ab057c2dab3,2,2,4
242,2021-05-31 15:07:41+01:00,index.rst,doc\source,5cf06bf33d8f187d444f812177946e134e4c9932,0,1,1
243,2021-06-01 15:11:50+01:00,availability-zones.rst,doc\source,7c7a2a142d74a7deeda2a79baf21b689fe32cd08,4,6,10
244,2021-06-01 15:11:50+01:00,schedulers.rst,doc\source,7c7a2a142d74a7deeda2a79baf21b689fe32cd08,7,3,10
245,2021-06-01 15:11:50+01:00,scheduler.py,nova\conf,7c7a2a142d74a7deeda2a79baf21b689fe32cd08,15,4,19
246,2021-06-01 15:11:50+01:00,availability_zone_filter.py,nova\scheduler,7c7a2a142d74a7deeda2a79baf21b689fe32cd08,15,0,15
247,2021-06-01 15:11:50+01:00,test_aggregates.py,nova\tests,7c7a2a142d74a7deeda2a79baf21b689fe32cd08,0,8,8
248,2021-06-01 15:11:50+01:00,deprecate-AZ-filter-28406abc0135c1c3.yaml,releasenotes\notes,7c7a2a142d74a7deeda2a79baf21b689fe32cd08,18,0,18
249,2021-06-01 11:29:38-03:00,manager.py,nova\compute,33c8af1f8c46c9c37fcc28fb3409fbd3a78ae39f,94,16,110
250,2021-06-01 11:29:38-03:00,test_compute_mgr.py,nova\tests,33c8af1f8c46c9c37fcc28fb3409fbd3a78ae39f,106,8,114
251,2021-06-01 11:29:38-03:00,bug-1821755-7bd03319e34b6b10.yaml,releasenotes\notes,33c8af1f8c46c9c37fcc28fb3409fbd3a78ae39f,11,0,11
252,2021-06-02 15:41:51+01:00,driver.py,nova\virt,1cc52fd2f22ec37194519e473c88260bf90a3c8c,6,2,8
253,2021-06-02 15:41:51+01:00,fake.py,nova\virt,1cc52fd2f22ec37194519e473c88260bf90a3c8c,3,2,5
254,2021-06-02 15:41:51+01:00,driver.py,nova\virt,1cc52fd2f22ec37194519e473c88260bf90a3c8c,3,2,5
255,2021-06-02 15:41:51+01:00,driver.py,nova\virt,1cc52fd2f22ec37194519e473c88260bf90a3c8c,4,1,5
256,2021-06-02 15:41:51+01:00,driver.py,nova\virt,1cc52fd2f22ec37194519e473c88260bf90a3c8c,4,2,6
257,2021-06-02 15:41:51+01:00,driver.py,nova\virt,1cc52fd2f22ec37194519e473c88260bf90a3c8c,3,2,5
258,2021-06-02 20:27:09-05:00,servers.py,nova\policies,2c761066e0a2a3eaafa4919ec5102f68d401f050,0,20,20
259,2021-06-03 09:46:18-05:00,policy-concepts.rst,doc\source,0b63f9effef6d11a91b08c598059b8746eac7fe8,63,0,63
260,2021-06-03 19:29:34+00:00,test_report.py,nova\tests,7b11409463de6efedab54aa0dcd0b9c423521c0a,31,31,62
261,2021-06-04 09:03:43+02:00,test_evacuate.py,nova\tests,bfde6861307e4667ebe99fd9c49ad4235e183381,0,4,4
262,2021-06-04 09:03:43+02:00,test_migrate_server.py,nova\tests,bfde6861307e4667ebe99fd9c49ad4235e183381,0,4,4
263,2021-06-04 09:03:43+02:00,test_server_actions.py,nova\tests,bfde6861307e4667ebe99fd9c49ad4235e183381,0,5,5
264,2021-06-07 09:31:14+01:00,test_driver.py,nova\tests,26d65fc882e42b824409dff87ff026dee1debe20,102,3,105
265,2021-06-07 09:31:14+01:00,driver.py,nova\virt,26d65fc882e42b824409dff87ff026dee1debe20,22,8,30
266,2021-06-07 18:29:32+01:00,test_designer.py,nova\tests,4d8bf15fec15dc3416023e577e0f2c277c216506,2,2,4
267,2021-06-07 18:29:32+01:00,test_driver.py,nova\tests,4d8bf15fec15dc3416023e577e0f2c277c216506,145,47,192
268,2021-06-07 18:29:32+01:00,test_migration.py,nova\tests,4d8bf15fec15dc3416023e577e0f2c277c216506,41,12,53
269,2021-06-07 18:29:32+01:00,designer.py,nova\virt,4d8bf15fec15dc3416023e577e0f2c277c216506,7,3,10
270,2021-06-07 18:29:32+01:00,driver.py,nova\virt,4d8bf15fec15dc3416023e577e0f2c277c216506,15,6,21
271,2021-06-07 18:29:32+01:00,migration.py,nova\virt,4d8bf15fec15dc3416023e577e0f2c277c216506,5,4,9
272,2021-06-09 15:18:47+01:00,lower-constraints.txt,,5c02091647f80fb3c818d5d47db2de49763c66cf,1,0,1
273,2021-06-09 15:18:47+01:00,test-requirements.txt,,5c02091647f80fb3c818d5d47db2de49763c66cf,1,0,1
274,2021-06-09 13:39:43-04:00,overview.rst,doc\source,7a0b2d34822d5347a8a83d1bb68592f6c1a1d102,8,0,8
275,2021-06-09 22:20:38+00:00,requestlog.py,nova\api,375a8452bbb2b3d12fbf82f725e977c3ce4b09b7,13,1,14
276,2021-06-09 22:20:38+00:00,test_requestlog.py,nova\tests,375a8452bbb2b3d12fbf82f725e977c3ce4b09b7,20,1,21
277,2021-06-10 11:00:22+02:00,tox.ini,,531fa4cd04ca1b8ee869f95d427ea26df0852541,1,1,2
278,2021-06-10 18:07:47+02:00,__init__.py,nova\tests,7085770b2019ec97ef28063f48048f99c3087278,0,0,0
279,2021-06-10 18:07:47+02:00,test_notifications.py,nova\tests,7085770b2019ec97ef28063f48048f99c3087278,9,10,19
280,2021-06-10 18:07:47+02:00,notifications.py,nova\tests,d71dfa8b8d7f3e170a0ff66064bdf950a787a028,171,8,179
281,2021-06-10 18:07:47+02:00,fake_notifier.py,nova\tests,d71dfa8b8d7f3e170a0ff66064bdf950a787a028,0,153,153
282,2021-06-11 11:47:28+02:00,tox.ini,,47bedbb77a95308bc585a7d40fcb343257e4ce0b,1,1,2
283,2021-06-11 13:31:48+01:00,.zuul.yaml,,7c478ac0992d9713c0fd7ea0a0498f0b7f92ce0d,4,2,6
284,2021-06-11 16:36:48+02:00,libvirt-distro-support-matrix.rst,doc\source,31491e5bc3a08ecf85b7efa276e9f818bb5e4898,7,6,13
285,2021-06-12 06:23:50+00:00,driver.py,nova\virt,7c7682149940465acb3d9c5023262af97886055c,5,0,5
286,2021-06-14 19:38:51+02:00,test_driver.py,nova\tests,eb67ec24e31d79749f2fa515fa69d861dfb12244,46,0,46
287,2021-06-14 19:38:51+02:00,driver.py,nova\virt,eb67ec24e31d79749f2fa515fa69d861dfb12244,9,1,10
288,2021-06-15 12:39:26+02:00,fs.py,nova\privsep,e59fc77c3d924cfab6ddcd780ae0604a84e64c30,11,4,15
289,2021-06-15 12:39:26+02:00,test_fs.py,nova\tests,e59fc77c3d924cfab6ddcd780ae0604a84e64c30,4,2,6
290,2021-06-15 07:35:36-04:00,middleware.py,nova,b02a95a18b5da37db6d4f30a5dea07e2a4187245,6,2,8
291,2021-06-15 17:35:20+01:00,test_evacuate.sh,gate,6aa580c15f919717cb17260f36e20e06afe24bae,0,164,164
292,2021-06-16 02:19:26+00:00,test_middleware.py,nova\tests,d9665465161e83afaefe16bba158fef4a83efede,28,0,28
293,2021-06-16 10:10:27+01:00,migration.py,nova\db,6df671fea75e1c91c0d28f364aeef5872cc7815a,0,38,38
294,2021-06-16 10:10:27+01:00,fakes.py,nova\tests,6df671fea75e1c91c0d28f364aeef5872cc7815a,0,133,133
295,2021-06-16 10:10:29+01:00,utils.py,nova\db,194df1fa628b4c4ba4a20e7e869f192e4f3c81e8,0,116,116
296,2021-06-16 10:10:29+01:00,exception.py,nova,194df1fa628b4c4ba4a20e7e869f192e4f3c81e8,0,4,4
297,2021-06-16 10:10:29+01:00,test_db_api.py,nova\tests,194df1fa628b4c4ba4a20e7e869f192e4f3c81e8,0,3,3
298,2021-06-16 10:10:29+01:00,test_migration_utils.py,nova\tests,194df1fa628b4c4ba4a20e7e869f192e4f3c81e8,0,189,189
299,2021-06-16 10:10:29+01:00,api.py,nova\db,d6cad899ca0de3662c19caa13636b19989c83f7a,0,39,39
300,2021-06-16 10:10:29+01:00,067_train.py,nova\db,3b18b788f20d5c7df44759043b3da86b561a5dd0,313,320,633
301,2021-06-16 10:10:29+01:00,402_train.py,nova\db,3b18b788f20d5c7df44759043b3da86b561a5dd0,892,877,1769
302,2021-06-16 10:10:29+01:00,402_train.py,nova\db,66daa87339bb4141a80a3ba614fd95cefed4c4b8,156,233,389
303,2021-06-16 10:10:29+01:00,402_train.py,nova\db,5819fe46a9bb0ee280cf3c46b11e77d260bc688c,85,112,197
304,2021-06-16 10:10:29+01:00,api.py,nova\compute,7ab2947720ce777a152dc8d2886ddc831f1756b9,14,20,34
305,2021-06-16 10:10:29+01:00,manager.py,nova\conductor,7ab2947720ce777a152dc8d2886ddc831f1756b9,1,3,4
306,2021-06-16 10:10:29+01:00,base.py,nova\db,7ab2947720ce777a152dc8d2886ddc831f1756b9,0,27,27
307,2021-06-16 10:10:29+01:00,manager.py,nova,7ab2947720ce777a152dc8d2886ddc831f1756b9,2,2,4
308,2021-06-16 10:10:29+01:00,neutron.py,nova\network,7ab2947720ce777a152dc8d2886ddc831f1756b9,1,3,4
309,2021-06-16 10:10:29+01:00,test_host_api.py,nova\tests,7ab2947720ce777a152dc8d2886ddc831f1756b9,99,105,204
310,2021-06-16 10:10:29+01:00,test_virtapi.py,nova\tests,7ab2947720ce777a152dc8d2886ddc831f1756b9,0,1,1
311,2021-06-16 10:10:29+01:00,api.py,nova\db,1d60cd7e0568913072effb8e3068dacc64dbdbbb,185,80,265
312,2021-06-16 10:10:29+01:00,api.py,nova\db,1d60cd7e0568913072effb8e3068dacc64dbdbbb,431,100,531
313,2021-06-16 10:10:29+01:00,migration.py,nova\db,1d60cd7e0568913072effb8e3068dacc64dbdbbb,3,0,3
314,2021-06-16 10:10:29+01:00,api.py,nova\db,b5dd59f8f9029a845ac352e87ab110d6e84511d0,25,23,48
315,2021-06-16 10:10:29+01:00,api.py,nova\db,b5dd59f8f9029a845ac352e87ab110d6e84511d0,27,20,47
316,2021-06-16 10:10:29+01:00,migration.py,nova\db,070e83b749a53ca802dc4eb53138970339914be4,27,32,59
317,2021-06-16 10:10:29+01:00,test_sqlalchemy_migration.py,nova\tests,070e83b749a53ca802dc4eb53138970339914be4,8,7,15
318,2021-06-16 15:51:38+01:00,.zuul.yaml,,98b01c9a59df4912f5a162c2c52d1f00c84d24c2,15,1,16
319,2021-06-16 15:51:38+01:00,check-cherry-picks.sh,tools,98b01c9a59df4912f5a162c2c52d1f00c84d24c2,0,5,5
320,2021-06-16 15:51:38+01:00,tox.ini,,98b01c9a59df4912f5a162c2c52d1f00c84d24c2,9,3,12
321,2021-06-17 01:57:12+00:00,nova-manage.rst,doc\source,bc71331bcaa92718fce06ac3d2ecda6a4c9d2d20,16,1,17
322,2021-06-17 01:57:12+00:00,manage.py,nova\cmd,bc71331bcaa92718fce06ac3d2ecda6a4c9d2d20,16,4,20
323,2021-06-17 01:57:12+00:00,api.py,nova\db,bc71331bcaa92718fce06ac3d2ecda6a4c9d2d20,4,2,6
324,2021-06-17 01:57:12+00:00,api.py,nova\db,bc71331bcaa92718fce06ac3d2ecda6a4c9d2d20,20,4,24
325,2021-06-17 01:57:12+00:00,test_archive.py,nova\tests,bc71331bcaa92718fce06ac3d2ecda6a4c9d2d20,68,12,80
326,2021-06-17 01:57:12+00:00,test_nova_manage.py,nova\tests,bc71331bcaa92718fce06ac3d2ecda6a4c9d2d20,117,0,117
327,2021-06-17 01:57:12+00:00,test_manage.py,nova\tests,bc71331bcaa92718fce06ac3d2ecda6a4c9d2d20,54,19,73
328,2021-06-17 01:57:12+00:00,test_db_api.py,nova\tests,bc71331bcaa92718fce06ac3d2ecda6a4c9d2d20,81,4,85
329,2021-06-17 01:57:12+00:00,archive-task-logs-fa9dd7c5859b5e30.yaml,releasenotes\notes,bc71331bcaa92718fce06ac3d2ecda6a4c9d2d20,22,0,22
330,2021-06-17 11:10:22+01:00,test_db_api.py,nova\tests,4de5a92d4e79776a5329c4020518f70f4f633a4e,37,17,54
331,2021-06-18 12:15:27+01:00,test_numa_servers.py,nova\tests,fe25fa13e0572aafb62b28bf7fa843a1860e5010,37,2,39
332,2021-06-18 12:34:22+01:00,instance_numa.py,nova\objects,387823b36d091abbaa37efb930fc98b94a5bbb93,2,0,2
333,2021-06-18 12:34:22+01:00,test_numa_servers.py,nova\tests,387823b36d091abbaa37efb930fc98b94a5bbb93,9,18,27
334,2021-06-18 12:34:22+01:00,test_hardware.py,nova\tests,387823b36d091abbaa37efb930fc98b94a5bbb93,20,161,181
335,2021-06-18 12:34:22+01:00,hardware.py,nova\virt,387823b36d091abbaa37efb930fc98b94a5bbb93,4,125,129
336,2021-06-18 12:34:22+01:00,driver.py,nova\virt,387823b36d091abbaa37efb930fc98b94a5bbb93,1,2,3
337,2021-06-18 12:34:22+01:00,bug-1910466-max-vcpu-topologies-with-numa-9a9ceb1b0fc7c33d.yaml,releasenotes\notes,387823b36d091abbaa37efb930fc98b94a5bbb93,23,0,23
338,2021-06-18 12:34:27+01:00,bindep.txt,,085de864db31631ead22f9c23488ed05b6bd5f88,5,3,8
339,2021-06-18 12:34:27+01:00,test-setup.sh,tools,085de864db31631ead22f9c23488ed05b6bd5f88,35,0,35
340,2021-06-18 12:34:44+01:00,.zuul.yaml,,b5b2e998249436e2b6fbdedc2343e9288ee735d9,29,4,33
341,2021-06-18 18:14:39+01:00,migrate_data.py,nova\objects,99cf5292c782828ea33a3448ae0e7da028d5d176,4,1,5
342,2021-06-18 18:14:39+01:00,test_migrate_data.py,nova\tests,99cf5292c782828ea33a3448ae0e7da028d5d176,21,0,21
343,2021-06-18 18:14:39+01:00,test_driver.py,nova\tests,99cf5292c782828ea33a3448ae0e7da028d5d176,22,0,22
344,2021-06-21 15:04:43+08:00,secure-live-migration-with-qemu-native-tls.rst,doc\source,c31d3f96b1e61fef1425355e89d0df46b7ed3345,1,1,2
345,2021-06-22 16:34:46+01:00,neutron.py,nova\network,fa0fb2fe3d61de1cb871c48ee97053cf2fb5827a,2,1,3
346,2021-06-22 16:34:46+01:00,test_neutron.py,nova\tests,fa0fb2fe3d61de1cb871c48ee97053cf2fb5827a,1,0,1
347,2021-06-23 13:05:35+00:00,.zuul.yaml,,17cca270a6c0a586a37754921cba26df3d8aff9b,4,4,8
348,2021-06-28 12:48:26+00:00,host.py,nova\virt,a569a51fedd058fdae2eb0066e087c37688987f8,17,4,21
349,2021-06-28 12:48:26+00:00,fix-pci-passthrough-for-cavium-thunderx-8fbd1c40718569e2.yaml,releasenotes\notes,a569a51fedd058fdae2eb0066e087c37688987f8,12,0,12
350,2021-06-29 11:40:04+01:00,driver.py,nova\scheduler,97d25371b3cbd20eab3b13b230fb87dfee8478bf,0,12,12
351,2021-06-29 11:40:04+01:00,filter_scheduler.py,nova\scheduler,97d25371b3cbd20eab3b13b230fb87dfee8478bf,9,14,23
352,2021-06-29 11:40:04+01:00,manager.py,nova\scheduler,97d25371b3cbd20eab3b13b230fb87dfee8478bf,1,1,2
353,2021-06-29 11:40:04+01:00,integrated_helpers.py,nova\tests,97d25371b3cbd20eab3b13b230fb87dfee8478bf,3,0,3
354,2021-06-29 11:40:04+01:00,test_bug_1671648.py,nova\tests,97d25371b3cbd20eab3b13b230fb87dfee8478bf,0,13,13
355,2021-06-29 11:40:04+01:00,test_bug_1741125.py,nova\tests,97d25371b3cbd20eab3b13b230fb87dfee8478bf,0,14,14
356,2021-06-29 11:40:04+01:00,test_bug_1741307.py,nova\tests,97d25371b3cbd20eab3b13b230fb87dfee8478bf,0,100,100
357,2021-06-29 11:40:04+01:00,test_nova_manage.py,nova\tests,97d25371b3cbd20eab3b13b230fb87dfee8478bf,29,30,59
358,2021-06-29 12:22:29+01:00,filter_scheduler.py,nova\scheduler,b20753b313089fd20bec3198104bbeaece3cad41,1,0,1
359,2021-06-29 12:22:29+01:00,host_manager.py,nova\scheduler,b20753b313089fd20bec3198104bbeaece3cad41,6,6,12
360,2021-06-29 12:22:29+01:00,manager.py,nova\scheduler,b20753b313089fd20bec3198104bbeaece3cad41,0,2,2
361,2021-06-29 12:22:29+01:00,test_host_manager.py,nova\tests,b20753b313089fd20bec3198104bbeaece3cad41,85,39,124
362,2021-06-29 12:23:32+01:00,driver.py,nova\scheduler,c4b47047837361a5a1ea80479dcfc634cca59286,0,9,9
363,2021-06-29 12:23:32+01:00,test_filter_scheduler.py,nova\tests,c4b47047837361a5a1ea80479dcfc634cca59286,0,17,17
364,2021-06-29 12:23:32+01:00,fakes.py,nova\tests,6d745036bc98cac674d2740dc20c2029dc201522,0,9,9
365,2021-06-29 12:24:41+01:00,eventlet-profiling.rst,doc\source,e0534cc2893dbe7bf844f7223cfbba84a2a4e782,17,58,75
366,2021-06-29 12:24:41+01:00,migrate.py,nova\conductor,e0534cc2893dbe7bf844f7223cfbba84a2a4e782,6,4,10
367,2021-06-29 12:24:41+01:00,driver.py,nova\scheduler,e0534cc2893dbe7bf844f7223cfbba84a2a4e782,472,9,481
368,2021-06-29 12:24:41+01:00,filter_scheduler.py,nova\scheduler,e0534cc2893dbe7bf844f7223cfbba84a2a4e782,0,489,489
369,2021-06-29 12:24:41+01:00,manager.py,nova\scheduler,e0534cc2893dbe7bf844f7223cfbba84a2a4e782,2,2,4
370,2021-06-29 12:24:41+01:00,test_bug_1781710.py,nova\tests,e0534cc2893dbe7bf844f7223cfbba84a2a4e782,8,6,14
371,2021-06-29 12:24:41+01:00,test_bug_1790204.py,nova\tests,e0534cc2893dbe7bf844f7223cfbba84a2a4e782,3,2,5
372,2021-06-29 12:24:41+01:00,test_servers.py,nova\tests,e0534cc2893dbe7bf844f7223cfbba84a2a4e782,4,4,8
373,2021-06-29 12:24:41+01:00,test_driver.py,nova\tests,e0534cc2893dbe7bf844f7223cfbba84a2a4e782,76,92,168
374,2021-06-29 12:24:41+01:00,test_manager.py,nova\tests,e0534cc2893dbe7bf844f7223cfbba84a2a4e782,0,14,14
375,2021-06-29 12:24:41+01:00,test_cross_cell.py,nova\tests,e0534cc2893dbe7bf844f7223cfbba84a2a4e782,1,1,2
376,2021-07-02 13:02:02-07:00,test_driver.py,nova\tests,f84d5917c6fb045f03645d9f80eafbc6e5f94bdd,12,0,12
377,2021-07-02 13:02:02-07:00,driver.py,nova\virt,f84d5917c6fb045f03645d9f80eafbc6e5f94bdd,15,1,16
378,2021-07-02 13:02:02-07:00,minimize-bug-1841481-race-window-f76912d4985770ad.yaml,releasenotes\notes,f84d5917c6fb045f03645d9f80eafbc6e5f94bdd,13,0,13
379,2021-07-04 16:00:55-05:00,lower-constraints.txt,,dfda0c0482acf579452742860cec2bdd64ac616a,1,1,2
380,2021-07-04 16:00:55-05:00,attach_interfaces.py,nova\policies,dfda0c0482acf579452742860cec2bdd64ac616a,11,16,27
381,2021-07-04 16:00:55-05:00,baremetal_nodes.py,nova\policies,dfda0c0482acf579452742860cec2bdd64ac616a,9,11,20
382,2021-07-04 16:00:55-05:00,base.py,nova\policies,dfda0c0482acf579452742860cec2bdd64ac616a,16,24,40
383,2021-07-04 16:00:55-05:00,deferred_delete.py,nova\policies,dfda0c0482acf579452742860cec2bdd64ac616a,9,11,20
384,2021-07-04 16:00:55-05:00,flavor_access.py,nova\policies,dfda0c0482acf579452742860cec2bdd64ac616a,8,8,16
385,2021-07-04 16:00:55-05:00,floating_ips.py,nova\policies,dfda0c0482acf579452742860cec2bdd64ac616a,13,23,36
386,2021-07-04 16:00:55-05:00,hosts.py,nova\policies,dfda0c0482acf579452742860cec2bdd64ac616a,13,23,36
387,2021-07-04 16:00:55-05:00,hypervisors.py,nova\policies,dfda0c0482acf579452742860cec2bdd64ac616a,15,26,41
388,2021-07-04 16:00:55-05:00,instance_actions.py,nova\policies,dfda0c0482acf579452742860cec2bdd64ac616a,10,11,21
389,2021-07-04 16:00:55-05:00,instance_usage_audit_log.py,nova\policies,dfda0c0482acf579452742860cec2bdd64ac616a,9,11,20
390,2021-07-04 16:00:55-05:00,limits.py,nova\policies,dfda0c0482acf579452742860cec2bdd64ac616a,8,7,15
391,2021-07-04 16:00:55-05:00,multinic.py,nova\policies,dfda0c0482acf579452742860cec2bdd64ac616a,9,11,20
392,2021-07-04 16:00:55-05:00,networks.py,nova\policies,dfda0c0482acf579452742860cec2bdd64ac616a,9,11,20
393,2021-07-04 16:00:55-05:00,rescue.py,nova\policies,dfda0c0482acf579452742860cec2bdd64ac616a,8,8,16
394,2021-07-04 16:00:55-05:00,security_groups.py,nova\policies,dfda0c0482acf579452742860cec2bdd64ac616a,17,35,52
395,2021-07-04 16:00:55-05:00,server_password.py,nova\policies,dfda0c0482acf579452742860cec2bdd64ac616a,9,11,20
396,2021-07-04 16:00:55-05:00,services.py,nova\policies,dfda0c0482acf579452742860cec2bdd64ac616a,11,13,24
397,2021-07-04 16:00:55-05:00,tenant_networks.py,nova\policies,dfda0c0482acf579452742860cec2bdd64ac616a,9,11,20
398,2021-07-04 16:00:55-05:00,volumes.py,nova\policies,dfda0c0482acf579452742860cec2bdd64ac616a,17,35,52
399,2021-07-04 16:00:55-05:00,requirements.txt,,dfda0c0482acf579452742860cec2bdd64ac616a,1,1,2
400,2021-07-05 09:10:23+08:00,claims.py,nova\compute,97a566ad9c3a6ab059dc94d154fb747e4b7d9ccd,2,0,2
401,2021-07-05 11:04:42+01:00,status.py,nova\cmd,43de2421b37e5e91418819f728c56bc56fa8d7ed,9,8,17
402,2021-07-05 11:04:42+01:00,api.py,nova\db,43de2421b37e5e91418819f728c56bc56fa8d7ed,107,107,214
403,2021-07-05 11:04:42+01:00,api_models.py,nova\db,43de2421b37e5e91418819f728c56bc56fa8d7ed,306,287,593
404,2021-07-05 11:04:42+01:00,models.py,nova\db,43de2421b37e5e91418819f728c56bc56fa8d7ed,603,581,1184
405,2021-07-05 11:04:42+01:00,aggregate.py,nova\objects,43de2421b37e5e91418819f728c56bc56fa8d7ed,13,14,27
406,2021-07-05 11:04:42+01:00,cell_mapping.py,nova\objects,43de2421b37e5e91418819f728c56bc56fa8d7ed,9,9,18
407,2021-07-05 11:04:42+01:00,compute_node.py,nova\objects,43de2421b37e5e91418819f728c56bc56fa8d7ed,6,7,13
408,2021-07-05 11:04:42+01:00,flavor.py,nova\objects,43de2421b37e5e91418819f728c56bc56fa8d7ed,12,12,24
409,2021-07-05 11:04:42+01:00,host_mapping.py,nova\objects,43de2421b37e5e91418819f728c56bc56fa8d7ed,5,5,10
410,2021-07-05 11:04:42+01:00,instance.py,nova\objects,43de2421b37e5e91418819f728c56bc56fa8d7ed,8,7,15
411,2021-07-05 11:04:42+01:00,instance_group.py,nova\objects,43de2421b37e5e91418819f728c56bc56fa8d7ed,4,5,9
412,2021-07-05 11:04:42+01:00,instance_mapping.py,nova\objects,43de2421b37e5e91418819f728c56bc56fa8d7ed,19,22,41
413,2021-07-05 11:04:42+01:00,quota.py,nova,43de2421b37e5e91418819f728c56bc56fa8d7ed,6,9,15
414,2021-07-05 11:04:42+01:00,test_archive.py,nova\tests,43de2421b37e5e91418819f728c56bc56fa8d7ed,3,4,7
415,2021-07-05 11:04:42+01:00,test_db_api.py,nova\tests,43de2421b37e5e91418819f728c56bc56fa8d7ed,21,24,45
416,2021-07-05 11:05:04+01:00,migration.py,nova\db,4bbea58cbb0f24f5be52738d8361c37d286506eb,110,6,116
417,2021-07-05 11:05:04+01:00,migration.py,nova\db,4bbea58cbb0f24f5be52738d8361c37d286506eb,0,140,140
418,2021-07-05 11:05:04+01:00,test_migrations.py,nova\tests,4bbea58cbb0f24f5be52738d8361c37d286506eb,3,5,8
419,2021-07-05 11:05:04+01:00,test_manage.py,nova\tests,4bbea58cbb0f24f5be52738d8361c37d286506eb,14,17,31
420,2021-07-05 11:05:04+01:00,test_migration.py,nova\tests,4bbea58cbb0f24f5be52738d8361c37d286506eb,1,1,2
421,2021-07-05 11:05:04+01:00,test_migrations.py,nova\tests,4bbea58cbb0f24f5be52738d8361c37d286506eb,7,8,15
422,2021-07-05 11:05:04+01:00,upgrade.rst,doc\source,bcf225daf4f265a052d71955abff19317ab3cc98,1,1,2
423,2021-07-05 11:05:04+01:00,README,nova\db,bcf225daf4f265a052d71955abff19317ab3cc98,0,0,0
424,2021-07-05 11:05:04+01:00,__init__.py,nova\db,bcf225daf4f265a052d71955abff19317ab3cc98,0,0,0
425,2021-07-05 11:05:04+01:00,manage.py,nova\db,bcf225daf4f265a052d71955abff19317ab3cc98,0,0,0
426,2021-07-05 11:05:04+01:00,migrate.cfg,nova\db,bcf225daf4f265a052d71955abff19317ab3cc98,0,0,0
427,2021-07-05 11:05:04+01:00,402_train.py,nova\db,bcf225daf4f265a052d71955abff19317ab3cc98,0,0,0
428,2021-07-05 11:05:04+01:00,403_placeholder.py,nova\db,bcf225daf4f265a052d71955abff19317ab3cc98,0,0,0
429,2021-07-05 11:05:04+01:00,404_placeholder.py,nova\db,bcf225daf4f265a052d71955abff19317ab3cc98,0,0,0
430,2021-07-05 11:05:04+01:00,405_placeholder.py,nova\db,bcf225daf4f265a052d71955abff19317ab3cc98,0,0,0
431,2021-07-05 11:05:04+01:00,406_placeholder.py,nova\db,bcf225daf4f265a052d71955abff19317ab3cc98,0,0,0
432,2021-07-05 11:05:04+01:00,407_placeholder.py,nova\db,bcf225daf4f265a052d71955abff19317ab3cc98,0,0,0
433,2021-07-05 11:05:04+01:00,408_placeholder.py,nova\db,bcf225daf4f265a052d71955abff19317ab3cc98,0,0,0
434,2021-07-05 11:05:04+01:00,409_placeholder.py,nova\db,bcf225daf4f265a052d71955abff19317ab3cc98,0,0,0
435,2021-07-05 11:05:04+01:00,410_placeholder.py,nova\db,bcf225daf4f265a052d71955abff19317ab3cc98,0,0,0
436,2021-07-05 11:05:04+01:00,411_placeholder.py,nova\db,bcf225daf4f265a052d71955abff19317ab3cc98,0,0,0
437,2021-07-05 11:05:04+01:00,412_placeholder.py,nova\db,bcf225daf4f265a052d71955abff19317ab3cc98,0,0,0
438,2021-07-05 11:05:04+01:00,413_placeholder.py,nova\db,bcf225daf4f265a052d71955abff19317ab3cc98,0,0,0
439,2021-07-05 11:05:04+01:00,414_placeholder.py,nova\db,bcf225daf4f265a052d71955abff19317ab3cc98,0,0,0
440,2021-07-05 11:05:04+01:00,415_placeholder.py,nova\db,bcf225daf4f265a052d71955abff19317ab3cc98,0,0,0
441,2021-07-05 11:05:04+01:00,416_placeholder.py,nova\db,bcf225daf4f265a052d71955abff19317ab3cc98,0,0,0
442,2021-07-05 11:05:04+01:00,417_placeholder.py,nova\db,bcf225daf4f265a052d71955abff19317ab3cc98,0,0,0
443,2021-07-05 11:05:04+01:00,418_placeholder.py,nova\db,bcf225daf4f265a052d71955abff19317ab3cc98,0,0,0
444,2021-07-05 11:05:04+01:00,419_placeholder.py,nova\db,bcf225daf4f265a052d71955abff19317ab3cc98,0,0,0
445,2021-07-05 11:05:04+01:00,420_placeholder.py,nova\db,bcf225daf4f265a052d71955abff19317ab3cc98,0,0,0
446,2021-07-05 11:05:04+01:00,421_placeholder.py,nova\db,bcf225daf4f265a052d71955abff19317ab3cc98,0,0,0
447,2021-07-05 11:05:04+01:00,422_placeholder.py,nova\db,bcf225daf4f265a052d71955abff19317ab3cc98,0,0,0
448,2021-07-05 11:05:04+01:00,__init__.py,nova\db,bcf225daf4f265a052d71955abff19317ab3cc98,0,0,0
449,2021-07-05 11:05:04+01:00,migration.py,nova\db,bcf225daf4f265a052d71955abff19317ab3cc98,1,1,2
450,2021-07-05 11:05:04+01:00,test_migrations.py,nova\tests,bcf225daf4f265a052d71955abff19317ab3cc98,10,5,15
451,2021-07-05 11:05:04+01:00,schema_diff.py,tools\db,bcf225daf4f265a052d71955abff19317ab3cc98,1,1,2
452,2021-07-05 11:05:04+01:00,reserve-migrations.py,tools,bcf225daf4f265a052d71955abff19317ab3cc98,1,1,2
453,2021-07-05 11:05:04+01:00,402_train.py,nova\db,089ae234a7ce4edaa63e135fc2de6a0c4efcb0c2,1,1,2
454,2021-07-05 11:05:04+01:00,models.py,nova\db,089ae234a7ce4edaa63e135fc2de6a0c4efcb0c2,1,1,2
455,2021-07-05 11:05:04+01:00,types.py,nova\db,089ae234a7ce4edaa63e135fc2de6a0c4efcb0c2,0,0,0
456,2021-07-05 11:05:04+01:00,test_db_api.py,nova\tests,089ae234a7ce4edaa63e135fc2de6a0c4efcb0c2,1,1,2
457,2021-07-05 11:10:09+01:00,manage.py,nova\cmd,014480d52fce238b36ab5750f36c9ab4ece4a6d2,3,2,5
458,2021-07-05 11:10:09+01:00,flavors.py,nova\compute,014480d52fce238b36ab5750f36c9ab4ece4a6d2,9,8,17
459,2021-07-05 11:10:09+01:00,api.py,nova\db,014480d52fce238b36ab5750f36c9ab4ece4a6d2,1,9,10
460,2021-07-05 11:10:09+01:00,test_flavor_manage.py,nova\tests,014480d52fce238b36ab5750f36c9ab4ece4a6d2,8,7,15
461,2021-07-05 11:10:09+01:00,test_quotas.py,nova\tests,014480d52fce238b36ab5750f36c9ab4ece4a6d2,2,2,4
462,2021-07-05 11:10:09+01:00,test_servers.py,nova\tests,014480d52fce238b36ab5750f36c9ab4ece4a6d2,2,2,4
463,2021-07-05 11:10:09+01:00,test_flavors.py,nova\tests,014480d52fce238b36ab5750f36c9ab4ece4a6d2,12,11,23
464,2021-07-05 11:10:10+01:00,nova-config-generator.conf,etc\nova,9799468d6f31ba8d915c851aae1a66340b5d1d7f,0,1,1
465,2021-07-05 11:10:10+01:00,api.py,nova\db,9799468d6f31ba8d915c851aae1a66340b5d1d7f,4,4,8
466,2021-07-05 11:10:10+01:00,drop-oslo_db-use_tpool-48542a28d10e1bae.yaml,releasenotes\notes,9799468d6f31ba8d915c851aae1a66340b5d1d7f,8,0,8
467,2021-07-06 14:40:09+01:00,servers.py,nova\api,8f21ee42bd66b62e75e14acf4e91b786d78b9168,80,0,80
468,2021-07-06 14:40:09+01:00,api.py,nova\compute,8f21ee42bd66b62e75e14acf4e91b786d78b9168,5,7,12
469,2021-07-06 14:40:09+01:00,test_servers.py,nova\tests,8f21ee42bd66b62e75e14acf4e91b786d78b9168,129,18,147
470,2021-07-06 14:40:09+01:00,test_servers.py,nova\tests,8f21ee42bd66b62e75e14acf4e91b786d78b9168,3,0,3
471,2021-07-07 10:56:12+00:00,manager.py,nova\compute,faa9de93d143ca8216c8774eed3397a4e9c2ae1f,0,6,6
472,2021-07-07 14:28:02+01:00,servers.py,nova\api,9cdecc81fb8729160693c244d8adf124eed8b9b2,1,0,1
473,2021-07-07 14:28:02+01:00,test_servers.py,nova\tests,9cdecc81fb8729160693c244d8adf124eed8b9b2,8,0,8
474,2021-07-07 13:29:07+00:00,launch-instance-from-volume.rst,doc\source,d88fe2895b7b3b1d47adbb9f3beb114313f0ba5a,260,241,501
475,2021-07-08 19:33:34+00:00,test_nova_manage.py,nova\tests,b84787d26a70ee62cba5b1d9376d1d78da388fa1,24,0,24
476,2021-07-09 15:51:38-03:00,test_compute_mgr.py,nova\tests,be9fe5ce6154ef116e631a11589bf60c9ecc4b71,7,2,9
477,2021-07-09 22:40:11+00:00,test.py,nova,87dba379aca6ec4613986cfa4e749a3ada2b44d0,4,1,5
478,2021-07-09 22:40:11+00:00,test_nova_manage.py,nova\tests,87dba379aca6ec4613986cfa4e749a3ada2b44d0,72,8,80
479,2021-07-14 11:19:11+01:00,lower-constraints.txt,,982e2ee02d7b1f1a367081d9d660a1d37505ce05,1,1,2
480,2021-07-14 11:19:11+01:00,exception.py,nova,982e2ee02d7b1f1a367081d9d660a1d37505ce05,4,4,8
481,2021-07-14 11:19:11+01:00,neutron.py,nova\network,982e2ee02d7b1f1a367081d9d660a1d37505ce05,99,188,287
482,2021-07-14 11:19:11+01:00,neutron.py,nova\tests,982e2ee02d7b1f1a367081d9d660a1d37505ce05,20,69,89
483,2021-07-14 11:19:11+01:00,test_servers.py,nova\tests,982e2ee02d7b1f1a367081d9d660a1d37505ce05,13,9,22
484,2021-07-14 11:19:11+01:00,test_neutron.py,nova\tests,982e2ee02d7b1f1a367081d9d660a1d37505ce05,144,182,326
485,2021-07-14 11:19:11+01:00,requirements.txt,,982e2ee02d7b1f1a367081d9d660a1d37505ce05,1,1,2
486,2021-07-15 11:27:13+09:00,manage.py,nova\cmd,1d3373dcf0a05d4a2c5b51fc1b74d41ec1bb1175,1,1,2
487,2021-07-15 10:46:01+01:00,nova.py,nova\tests,0aea2ac90344d5fbe39df2125d6885ddd5837f89,22,0,22
488,2021-07-15 10:46:51+01:00,nova.py,nova\tests,3bda965e15a3bda5c5f95e5d870accb4cc1b445f,6,10,16
489,2021-07-15 18:45:54-04:00,iscsi.py,nova\virt,ad60f23be3d562422b350aade04aa92ade39fb32,1,2,3
490,2021-07-16 15:41:37+02:00,lower-constraints.txt,,a22fe2da97a2484c3e1ca9dfd01557fa0a799dbb,1,1,2
491,2021-07-16 15:41:37+02:00,requirements.txt,,a22fe2da97a2484c3e1ca9dfd01557fa0a799dbb,1,1,2
492,2021-07-16 21:57:45+00:00,archive-task-logs-fa9dd7c5859b5e30.yaml,releasenotes\notes,d093849c3c70e46bf409b1051454cbf70bc12a1f,5,2,7
493,2021-07-19 11:48:05+02:00,compute.py,nova\conf,52d9dd2c0bbca1e8efcddf0539793b3481c095a5,2,1,3
494,2021-07-20 19:13:10+01:00,test_servers.py,nova\tests,4ee2f667b563cb485e743eefed89d1460e79ea5c,40,0,40
495,2021-07-21 12:20:22+02:00,lower-constraints.txt,,a65ea33824edc570e04acf994cea26edf874bf48,1,1,2
496,2021-07-21 12:20:22+02:00,nova.py,nova\tests,a65ea33824edc570e04acf994cea26edf874bf48,0,10,10
497,2021-07-21 12:20:22+02:00,requirements.txt,,a65ea33824edc570e04acf994cea26edf874bf48,1,1,2
498,2021-07-22 12:12:34+00:00,tox.ini,,89e321b7b5c88ab7cfab53103295774ca535f0df,2,1,3
499,2021-07-23 15:59:41+01:00,test_scheduler.py,nova\tests,f0d17e774f483a97865f5950ab792041f1d66cfb,111,0,111
500,2021-07-23 16:12:26+01:00,test_scheduler.py,nova\tests,809a52a16baaa530121a48b8bf6cfff5ed6914be,56,11,67
501,2021-07-26 17:15:30+01:00,test_cinder.py,nova\tests,1d850a1593a14c0bf33a395c0e0bdc4207a64483,1,1,2
502,2021-07-27 16:55:57+01:00,cpu-topologies.rst,doc\source,d4f9b03c5c0a907345e999dcf70ef18eac40dcda,1,1,2
503,2021-07-27 16:55:57+01:00,hw.py,nova\api,d4f9b03c5c0a907345e999dcf70ef18eac40dcda,130,64,194
504,2021-07-27 16:55:57+01:00,hw_rng.py,nova\api,d4f9b03c5c0a907345e999dcf70ef18eac40dcda,1,1,2
505,2021-07-27 16:55:57+01:00,null.py,nova\api,d4f9b03c5c0a907345e999dcf70ef18eac40dcda,4,4,8
506,2021-07-27 16:55:57+01:00,os.py,nova\api,d4f9b03c5c0a907345e999dcf70ef18eac40dcda,1,1,2
507,2021-07-27 16:55:57+01:00,pci_passthrough.py,nova\api,d4f9b03c5c0a907345e999dcf70ef18eac40dcda,8,3,11
508,2021-07-27 16:55:57+01:00,quota.py,nova\api,d4f9b03c5c0a907345e999dcf70ef18eac40dcda,110,23,133
509,2021-07-28 14:55:19+02:00,test_services.py,nova\tests,32257a2a6d159406577c885a9d7e366cbf0c72b9,19,0,19
510,2021-07-28 14:57:36+02:00,services.py,nova\api,880611df0b6b967adabd3f08886e385d0a100c5c,19,4,23
511,2021-07-28 14:57:36+02:00,test_services.py,nova\tests,880611df0b6b967adabd3f08886e385d0a100c5c,1,5,6
512,2021-07-28 19:54:29+00:00,driver.py,nova\virt,f916266d4f5949d1501319a916d6e005d47efd58,4,6,10
513,2021-07-29 12:46:28+01:00,test_servers.py,nova\tests,48f35058fe6f821644b4b188a1273a4d8e547d78,0,1,1
514,2021-07-29 12:46:28+01:00,fakes.py,nova\tests,48f35058fe6f821644b4b188a1273a4d8e547d78,0,24,24
515,2021-07-30 15:10:40+02:00,services.py,nova\api,a3d0aa477288cf5b0991690baadb4e2d1db00d82,2,1,3
516,2021-07-31 00:35:38+00:00,test_websocketproxy.py,nova\tests,214cabe6848a1fdb4f5941d994c6cc11107fc4af,13,14,27
517,2021-07-31 16:01:32+00:00,test_nova_manage.py,nova\tests,39ef1ad774859562183190f74831a115698e6836,41,32,73
518,2021-08-03 10:06:25+01:00,.zuul.yaml,,dbf3e276ba5971f1f6483e04b84cb0fc403cd592,2,0,2
519,2021-08-03 16:54:54+02:00,virtual-gpu.rst,doc\source,ff4d0d002a35022df1cb71029ad82ad8f3b327df,5,5,10
520,2021-08-03 16:54:54+02:00,devices.py,nova\conf,ff4d0d002a35022df1cb71029ad82ad8f3b327df,26,22,48
521,2021-08-03 16:54:54+02:00,test_reshape.py,nova\tests,ff4d0d002a35022df1cb71029ad82ad8f3b327df,2,2,4
522,2021-08-03 16:54:54+02:00,test_vgpu.py,nova\tests,ff4d0d002a35022df1cb71029ad82ad8f3b327df,4,4,8
523,2021-08-03 16:54:54+02:00,test_devices.py,nova\tests,ff4d0d002a35022df1cb71029ad82ad8f3b327df,7,7,14
524,2021-08-03 16:54:54+02:00,test_driver.py,nova\tests,ff4d0d002a35022df1cb71029ad82ad8f3b327df,41,41,82
525,2021-08-03 16:54:54+02:00,driver.py,nova\virt,ff4d0d002a35022df1cb71029ad82ad8f3b327df,24,24,48
526,2021-08-03 16:54:54+02:00,generic_mdevs-0e1b3ef8385f7fae.yaml,releasenotes\notes,ff4d0d002a35022df1cb71029ad82ad8f3b327df,13,0,13
527,2021-08-04 11:37:26+00:00,exception.py,nova,49ba5a763f9d2c7c496f391ca8149a18541bfec7,5,0,5
528,2021-08-04 11:37:26+00:00,test_driver.py,nova\tests,49ba5a763f9d2c7c496f391ca8149a18541bfec7,91,29,120
529,2021-08-04 11:37:26+00:00,driver.py,nova\virt,49ba5a763f9d2c7c496f391ca8149a18541bfec7,12,3,15
530,2021-08-04 12:37:43+01:00,manager.py,nova\compute,2209b0007fe85d7c5439e0bfdfe2120c63898fa2,6,0,6
531,2021-08-04 12:37:43+01:00,test_bug_1937375.py,nova\tests,2209b0007fe85d7c5439e0bfdfe2120c63898fa2,9,6,15
532,2021-08-04 12:37:43+01:00,test_compute_mgr.py,nova\tests,2209b0007fe85d7c5439e0bfdfe2120c63898fa2,26,0,26
533,2021-08-04 12:37:43+01:00,integrated_helpers.py,nova\tests,753a2ae5d4159db3ee3ca06388193fe2c436fc66,18,0,18
534,2021-08-04 12:37:43+01:00,test_bug_1675570.py,nova\tests,753a2ae5d4159db3ee3ca06388193fe2c436fc66,8,83,91
535,2021-08-04 12:37:43+01:00,test_bug_1937375.py,nova\tests,753a2ae5d4159db3ee3ca06388193fe2c436fc66,0,21,21
536,2021-08-04 12:37:43+01:00,test_conf_max_attach_disk_devices.py,nova\tests,753a2ae5d4159db3ee3ca06388193fe2c436fc66,0,14,14
537,2021-08-04 12:37:43+01:00,test_bug_1937375.py,nova\tests,2ffd9738602531e93495a1feca76bbb687c3e72c,95,0,95
538,2021-08-05 15:58:23+08:00,cyborg.py,nova\accelerator,9c55d5d59da3543bcc79e8e4aaaed5588defe4c1,88,15,103
539,2021-08-05 15:58:23+08:00,test_cyborg.py,nova\tests,9c55d5d59da3543bcc79e8e4aaaed5588defe4c1,98,5,103
540,2021-08-05 15:58:25+08:00,model.py,nova\network,8b84135f2d45370f94a0a6261af2e2fb6cefae5b,18,1,19
541,2021-08-05 15:58:25+08:00,neutron.py,nova\network,8b84135f2d45370f94a0a6261af2e2fb6cefae5b,2,2,4
542,2021-08-05 15:58:25+08:00,network_request.py,nova\objects,8b84135f2d45370f94a0a6261af2e2fb6cefae5b,18,4,22
543,2021-08-05 15:58:25+08:00,test_servers.py,nova\tests,8b84135f2d45370f94a0a6261af2e2fb6cefae5b,12,7,19
544,2021-08-05 15:58:25+08:00,test_neutron.py,nova\tests,8b84135f2d45370f94a0a6261af2e2fb6cefae5b,27,17,44
545,2021-08-05 15:58:25+08:00,test_network_request.py,nova\tests,8b84135f2d45370f94a0a6261af2e2fb6cefae5b,22,4,26
546,2021-08-05 15:58:25+08:00,test_objects.py,nova\tests,8b84135f2d45370f94a0a6261af2e2fb6cefae5b,1,1,2
547,2021-08-05 15:58:25+08:00,test_vif.py,nova\tests,8b84135f2d45370f94a0a6261af2e2fb6cefae5b,31,2,33
548,2021-08-05 15:58:25+08:00,vif.py,nova\virt,8b84135f2d45370f94a0a6261af2e2fb6cefae5b,2,1,3
549,2021-08-05 15:58:29+08:00,manager.py,nova\conductor,b90c828d7046fed166e41576ec2806d13c4f78ec,88,21,109
550,2021-08-05 15:58:29+08:00,neutron.py,nova\network,b90c828d7046fed166e41576ec2806d13c4f78ec,24,4,28
551,2021-08-05 15:58:29+08:00,test_conductor.py,nova\tests,b90c828d7046fed166e41576ec2806d13c4f78ec,285,22,307
552,2021-08-05 15:58:29+08:00,test_neutron.py,nova\tests,b90c828d7046fed166e41576ec2806d13c4f78ec,115,12,127
553,2021-08-05 15:58:31+08:00,manager.py,nova\compute,120fe8af93dae067ef18bd8e66d8a4e16cbd9770,52,21,73
554,2021-08-05 15:58:31+08:00,neutron.py,nova\network,120fe8af93dae067ef18bd8e66d8a4e16cbd9770,25,7,32
555,2021-08-05 15:58:31+08:00,test_compute_mgr.py,nova\tests,120fe8af93dae067ef18bd8e66d8a4e16cbd9770,114,37,151
556,2021-08-05 15:58:31+08:00,test_neutron.py,nova\tests,120fe8af93dae067ef18bd8e66d8a4e16cbd9770,51,11,62
557,2021-08-05 15:58:34+08:00,manager.py,nova\compute,e19fa1a1997c6d18d440dcdc5a0732b7e2467fa5,11,2,13
558,2021-08-05 15:58:34+08:00,utils.py,nova\compute,e19fa1a1997c6d18d440dcdc5a0732b7e2467fa5,22,10,32
559,2021-08-05 15:58:34+08:00,manager.py,nova\conductor,e19fa1a1997c6d18d440dcdc5a0732b7e2467fa5,7,1,8
560,2021-08-05 15:58:34+08:00,neutron.py,nova\network,e19fa1a1997c6d18d440dcdc5a0732b7e2467fa5,9,1,10
561,2021-08-05 15:58:34+08:00,test_compute_mgr.py,nova\tests,e19fa1a1997c6d18d440dcdc5a0732b7e2467fa5,6,1,7
562,2021-08-05 15:58:34+08:00,test_compute_utils.py,nova\tests,e19fa1a1997c6d18d440dcdc5a0732b7e2467fa5,19,0,19
563,2021-08-05 15:58:34+08:00,test_conductor.py,nova\tests,e19fa1a1997c6d18d440dcdc5a0732b7e2467fa5,19,1,20
564,2021-08-05 15:58:34+08:00,test_neutron.py,nova\tests,e19fa1a1997c6d18d440dcdc5a0732b7e2467fa5,20,0,20
565,2021-08-05 15:58:41+08:00,cyborg.py,nova\accelerator,1f53176d2f4303b909ecad18cb0f027bfcd0b7ae,33,10,43
566,2021-08-05 15:58:41+08:00,attach_interfaces.py,nova\api,1f53176d2f4303b909ecad18cb0f027bfcd0b7ae,5,2,7
567,2021-08-05 15:58:41+08:00,evacuate.py,nova\api,1f53176d2f4303b909ecad18cb0f027bfcd0b7ae,4,1,5
568,2021-08-05 15:58:41+08:00,migrate_server.py,nova\api,1f53176d2f4303b909ecad18cb0f027bfcd0b7ae,4,2,6
569,2021-08-05 15:58:41+08:00,servers.py,nova\api,1f53176d2f4303b909ecad18cb0f027bfcd0b7ae,4,2,6
570,2021-08-05 15:58:41+08:00,shelve.py,nova\api,1f53176d2f4303b909ecad18cb0f027bfcd0b7ae,7,2,9
571,2021-08-05 15:58:41+08:00,suspend_server.py,nova\api,1f53176d2f4303b909ecad18cb0f027bfcd0b7ae,3,1,4
572,2021-08-05 15:58:41+08:00,api.py,nova\compute,1f53176d2f4303b909ecad18cb0f027bfcd0b7ae,49,0,49
573,2021-08-05 15:58:41+08:00,exception.py,nova,1f53176d2f4303b909ecad18cb0f027bfcd0b7ae,4,0,4
574,2021-08-05 15:58:41+08:00,neutron.py,nova\network,1f53176d2f4303b909ecad18cb0f027bfcd0b7ae,11,3,14
575,2021-08-05 15:58:41+08:00,service.py,nova\objects,1f53176d2f4303b909ecad18cb0f027bfcd0b7ae,4,1,5
576,2021-08-05 15:58:41+08:00,test_cyborg.py,nova\tests,1f53176d2f4303b909ecad18cb0f027bfcd0b7ae,23,6,29
577,2021-08-05 15:58:41+08:00,admin_only_action_common.py,nova\tests,1f53176d2f4303b909ecad18cb0f027bfcd0b7ae,2,1,3
578,2021-08-05 15:58:41+08:00,test_api.py,nova\tests,1f53176d2f4303b909ecad18cb0f027bfcd0b7ae,92,1,93
579,2021-08-05 15:58:41+08:00,test_compute.py,nova\tests,1f53176d2f4303b909ecad18cb0f027bfcd0b7ae,5,3,8
580,2021-08-05 15:58:41+08:00,test_conductor.py,nova\tests,1f53176d2f4303b909ecad18cb0f027bfcd0b7ae,4,2,6
581,2021-08-05 15:58:41+08:00,test_neutron.py,nova\tests,1f53176d2f4303b909ecad18cb0f027bfcd0b7ae,43,4,47
582,2021-08-05 15:58:41+08:00,test_servers.py,nova\tests,1f53176d2f4303b909ecad18cb0f027bfcd0b7ae,1,1,2
583,2021-08-05 15:58:41+08:00,smartnic-support-0339efe4b68075fe.yaml,releasenotes\notes,1f53176d2f4303b909ecad18cb0f027bfcd0b7ae,9,0,9
584,2021-08-05 15:58:43+08:00,cyborg.py,nova\tests,c3245098e366e68f6d353d9f6ba0b40af9adb95b,219,70,289
585,2021-08-05 15:58:43+08:00,neutron.py,nova\tests,c3245098e366e68f6d353d9f6ba0b40af9adb95b,84,0,84
586,2021-08-05 15:58:43+08:00,test_servers.py,nova\tests,c3245098e366e68f6d353d9f6ba0b40af9adb95b,459,53,512
587,2021-08-05 15:58:43+08:00,test_compute_mgr.py,nova\tests,c3245098e366e68f6d353d9f6ba0b40af9adb95b,4,4,8
588,2021-08-05 15:58:43+08:00,test_conductor.py,nova\tests,c3245098e366e68f6d353d9f6ba0b40af9adb95b,1,1,2
589,2021-08-05 10:13:47+01:00,integrated_helpers.py,nova\tests,ede7866de4865cfd23a996a83084cc75567094c9,21,0,21
590,2021-08-05 10:13:47+01:00,test_bug_1938326.py,nova\tests,ede7866de4865cfd23a996a83084cc75567094c9,143,0,143
591,2021-08-05 11:31:21+02:00,devices.py,nova\conf,9cf07d5aaacf8c61a45b6342d7e7471bab422c12,1,1,2
592,2021-08-05 11:31:21+02:00,exception.py,nova,9cf07d5aaacf8c61a45b6342d7e7471bab422c12,2,2,4
593,2021-08-05 11:31:21+02:00,test_driver.py,nova\tests,9cf07d5aaacf8c61a45b6342d7e7471bab422c12,6,5,11
594,2021-08-05 11:31:21+02:00,driver.py,nova\virt,9cf07d5aaacf8c61a45b6342d7e7471bab422c12,14,15,29
595,2021-08-05 13:01:47+01:00,.zuul.yaml,,4e18f07670714af605c24448636e994f022c6589,6,0,6
596,2021-08-06 10:07:05+01:00,test_cross_cell_migrate.py,nova\tests,d4dbcd5fa05ac2f988b65d611f71805f90411581,1,1,2
597,2021-08-06 15:58:39+02:00,orphaned-allocations.rst,doc\source,59c2262ca58460921b6ca7ee2bb74841f2f7dc0b,7,2,9
598,2021-08-06 15:58:39+02:00,nova-manage.rst,doc\source,59c2262ca58460921b6ca7ee2bb74841f2f7dc0b,9,0,9
599,2021-08-06 15:58:39+02:00,manage.py,nova\cmd,59c2262ca58460921b6ca7ee2bb74841f2f7dc0b,23,1,24
600,2021-08-06 15:58:39+02:00,exception.py,nova,59c2262ca58460921b6ca7ee2bb74841f2f7dc0b,18,0,18
601,2021-08-06 15:58:39+02:00,test_nova_manage.py,nova\tests,59c2262ca58460921b6ca7ee2bb74841f2f7dc0b,44,0,44
602,2021-08-06 15:58:39+02:00,test_manage.py,nova\tests,59c2262ca58460921b6ca7ee2bb74841f2f7dc0b,9,6,15
603,2021-08-09 15:34:39+01:00,database.py,nova\conf,84b61790763f91e12eebb96d955e2f83abc00d56,27,90,117
604,2021-08-09 15:34:40+01:00,nova-config-generator.conf,etc\nova,100b9dc62c0ec9f7b38739837c06646122c818d5,0,1,1
605,2021-08-09 15:34:40+01:00,common.py,nova\cmd,100b9dc62c0ec9f7b38739837c06646122c818d5,1,19,20
606,2021-08-09 15:34:40+01:00,compute.py,nova\cmd,100b9dc62c0ec9f7b38739837c06646122c818d5,3,2,5
607,2021-08-09 15:34:40+01:00,manage.py,nova\cmd,100b9dc62c0ec9f7b38739837c06646122c818d5,6,8,14
608,2021-08-09 15:34:40+01:00,policy.py,nova\cmd,100b9dc62c0ec9f7b38739837c06646122c818d5,1,1,2
609,2021-08-09 15:34:40+01:00,status.py,nova\cmd,100b9dc62c0ec9f7b38739837c06646122c818d5,1,1,2
610,2021-08-09 15:34:40+01:00,api.py,nova\compute,100b9dc62c0ec9f7b38739837c06646122c818d5,4,5,9
611,2021-08-09 15:34:40+01:00,flavors.py,nova\compute,100b9dc62c0ec9f7b38739837c06646122c818d5,2,1,3
612,2021-08-09 15:34:40+01:00,instance_list.py,nova\compute,100b9dc62c0ec9f7b38739837c06646122c818d5,1,1,2
613,2021-08-09 15:34:40+01:00,migration_list.py,nova\compute,100b9dc62c0ec9f7b38739837c06646122c818d5,1,1,2
614,2021-08-09 15:34:40+01:00,database.py,nova\conf,100b9dc62c0ec9f7b38739837c06646122c818d5,2,6,8
615,2021-08-09 15:34:40+01:00,config.py,nova,100b9dc62c0ec9f7b38739837c06646122c818d5,2,2,4
616,2021-08-09 15:34:40+01:00,context.py,nova,100b9dc62c0ec9f7b38739837c06646122c818d5,1,1,2
617,2021-08-09 15:34:40+01:00,__init__.py,nova\db,100b9dc62c0ec9f7b38739837c06646122c818d5,0,13,13
618,2021-08-09 15:34:40+01:00,api.py,nova\db,100b9dc62c0ec9f7b38739837c06646122c818d5,0,1463,1463
619,2021-08-09 15:34:40+01:00,__init__.py,nova\db,100b9dc62c0ec9f7b38739837c06646122c818d5,0,0,0
620,2021-08-09 15:34:40+01:00,api.py,nova\db,100b9dc62c0ec9f7b38739837c06646122c818d5,18,3,21
621,2021-08-09 15:34:40+01:00,models.py,nova\db,100b9dc62c0ec9f7b38739837c06646122c818d5,0,0,0
622,2021-08-09 15:34:40+01:00,migration.py,nova\db,100b9dc62c0ec9f7b38739837c06646122c818d5,1,1,2
623,2021-08-09 15:34:40+01:00,checks.py,nova\hacking,100b9dc62c0ec9f7b38739837c06646122c818d5,2,2,4
624,2021-08-09 15:34:40+01:00,manager.py,nova,100b9dc62c0ec9f7b38739837c06646122c818d5,1,1,2
625,2021-08-09 15:34:40+01:00,aggregate.py,nova\objects,100b9dc62c0ec9f7b38739837c06646122c818d5,1,1,2
626,2021-08-09 15:34:40+01:00,bandwidth_usage.py,nova\objects,100b9dc62c0ec9f7b38739837c06646122c818d5,1,1,2
627,2021-08-09 15:34:40+01:00,block_device.py,nova\objects,100b9dc62c0ec9f7b38739837c06646122c818d5,4,5,9
628,2021-08-09 15:34:40+01:00,build_request.py,nova\objects,100b9dc62c0ec9f7b38739837c06646122c818d5,1,1,2
629,2021-08-09 15:34:40+01:00,cell_mapping.py,nova\objects,100b9dc62c0ec9f7b38739837c06646122c818d5,1,1,2
630,2021-08-09 15:34:40+01:00,compute_node.py,nova\objects,100b9dc62c0ec9f7b38739837c06646122c818d5,4,5,9
631,2021-08-09 15:34:40+01:00,console_auth_token.py,nova\objects,100b9dc62c0ec9f7b38739837c06646122c818d5,1,1,2
632,2021-08-09 15:34:40+01:00,ec2.py,nova\objects,100b9dc62c0ec9f7b38739837c06646122c818d5,1,1,2
633,2021-08-09 15:34:40+01:00,flavor.py,nova\objects,100b9dc62c0ec9f7b38739837c06646122c818d5,4,5,9
634,2021-08-09 15:34:40+01:00,host_mapping.py,nova\objects,100b9dc62c0ec9f7b38739837c06646122c818d5,1,1,2
635,2021-08-09 15:34:40+01:00,instance.py,nova\objects,100b9dc62c0ec9f7b38739837c06646122c818d5,8,9,17
636,2021-08-09 15:34:40+01:00,instance_action.py,nova\objects,100b9dc62c0ec9f7b38739837c06646122c818d5,1,1,2
637,2021-08-09 15:34:40+01:00,instance_fault.py,nova\objects,100b9dc62c0ec9f7b38739837c06646122c818d5,1,1,2
638,2021-08-09 15:34:40+01:00,instance_group.py,nova\objects,100b9dc62c0ec9f7b38739837c06646122c818d5,1,1,2
639,2021-08-09 15:34:40+01:00,instance_info_cache.py,nova\objects,100b9dc62c0ec9f7b38739837c06646122c818d5,1,1,2
640,2021-08-09 15:34:40+01:00,instance_mapping.py,nova\objects,100b9dc62c0ec9f7b38739837c06646122c818d5,1,1,2
641,2021-08-09 15:34:40+01:00,instance_numa.py,nova\objects,100b9dc62c0ec9f7b38739837c06646122c818d5,1,1,2
642,2021-08-09 15:34:40+01:00,instance_pci_requests.py,nova\objects,100b9dc62c0ec9f7b38739837c06646122c818d5,1,1,2
643,2021-08-09 15:34:40+01:00,keypair.py,nova\objects,100b9dc62c0ec9f7b38739837c06646122c818d5,5,6,11
644,2021-08-09 15:34:40+01:00,migration.py,nova\objects,100b9dc62c0ec9f7b38739837c06646122c818d5,1,1,2
645,2021-08-09 15:34:40+01:00,migration_context.py,nova\objects,100b9dc62c0ec9f7b38739837c06646122c818d5,1,1,2
646,2021-08-09 15:34:40+01:00,pci_device.py,nova\objects,100b9dc62c0ec9f7b38739837c06646122c818d5,4,5,9
647,2021-08-09 15:34:40+01:00,quotas.py,nova\objects,100b9dc62c0ec9f7b38739837c06646122c818d5,30,31,61
648,2021-08-09 15:34:40+01:00,request_spec.py,nova\objects,100b9dc62c0ec9f7b38739837c06646122c818d5,1,1,2
649,2021-08-09 15:34:40+01:00,resource.py,nova\objects,100b9dc62c0ec9f7b38739837c06646122c818d5,1,1,2
650,2021-08-09 15:34:40+01:00,security_group.py,nova\objects,100b9dc62c0ec9f7b38739837c06646122c818d5,3,4,7
651,2021-08-09 15:34:40+01:00,service.py,nova\objects,100b9dc62c0ec9f7b38739837c06646122c818d5,1,1,2
652,2021-08-09 15:34:40+01:00,tag.py,nova\objects,100b9dc62c0ec9f7b38739837c06646122c818d5,1,1,2
653,2021-08-09 15:34:40+01:00,task_log.py,nova\objects,100b9dc62c0ec9f7b38739837c06646122c818d5,1,1,2
654,2021-08-09 15:34:40+01:00,trusted_certs.py,nova\objects,100b9dc62c0ec9f7b38739837c06646122c818d5,1,1,2
655,2021-08-09 15:34:40+01:00,vcpu_model.py,nova\objects,100b9dc62c0ec9f7b38739837c06646122c818d5,1,1,2
656,2021-08-09 15:34:40+01:00,virt_device_metadata.py,nova\objects,100b9dc62c0ec9f7b38739837c06646122c818d5,1,1,2
657,2021-08-09 15:34:40+01:00,virtual_interface.py,nova\objects,100b9dc62c0ec9f7b38739837c06646122c818d5,5,6,11
658,2021-08-09 15:34:40+01:00,volume_usage.py,nova\objects,100b9dc62c0ec9f7b38739837c06646122c818d5,1,1,2
659,2021-08-09 15:34:40+01:00,quota.py,nova,100b9dc62c0ec9f7b38739837c06646122c818d5,2,3,5
660,2021-08-09 15:34:40+01:00,test.py,nova,100b9dc62c0ec9f7b38739837c06646122c818d5,2,2,4
661,2021-08-09 15:34:40+01:00,nova.py,nova\tests,100b9dc62c0ec9f7b38739837c06646122c818d5,6,5,11
662,2021-08-09 15:34:40+01:00,test_migrate_server.py,nova\tests,100b9dc62c0ec9f7b38739837c06646122c818d5,2,2,4
663,2021-08-09 15:34:40+01:00,test_server_migrations.py,nova\tests,100b9dc62c0ec9f7b38739837c06646122c818d5,1,1,2
664,2021-08-09 15:34:40+01:00,test_server_tags.py,nova\tests,100b9dc62c0ec9f7b38739837c06646122c818d5,1,1,2
665,2021-08-09 15:34:40+01:00,test_servers.py,nova\tests,100b9dc62c0ec9f7b38739837c06646122c818d5,2,2,4
666,2021-08-09 15:34:40+01:00,test_services.py,nova\tests,100b9dc62c0ec9f7b38739837c06646122c818d5,5,5,10
667,2021-08-09 15:34:40+01:00,test_instance_list.py,nova\tests,100b9dc62c0ec9f7b38739837c06646122c818d5,1,1,2
668,2021-08-09 15:34:40+01:00,test_aggregate.py,nova\tests,100b9dc62c0ec9f7b38739837c06646122c818d5,1,1,2
669,2021-08-09 15:34:40+01:00,test_aggregate_model.py,nova\tests,100b9dc62c0ec9f7b38739837c06646122c818d5,1,1,2
670,2021-08-09 15:34:40+01:00,test_archive.py,nova\tests,100b9dc62c0ec9f7b38739837c06646122c818d5,7,10,17
671,2021-08-09 15:34:40+01:00,test_compute_node.py,nova\tests,100b9dc62c0ec9f7b38739837c06646122c818d5,1,1,2
672,2021-08-09 15:34:40+01:00,test_flavor.py,nova\tests,100b9dc62c0ec9f7b38739837c06646122c818d5,1,1,2
673,2021-08-09 15:34:40+01:00,test_flavor_model.py,nova\tests,100b9dc62c0ec9f7b38739837c06646122c818d5,1,1,2
674,2021-08-09 15:34:40+01:00,test_instance.py,nova\tests,100b9dc62c0ec9f7b38739837c06646122c818d5,1,1,2
675,2021-08-09 15:34:40+01:00,test_keypair.py,nova\tests,100b9dc62c0ec9f7b38739837c06646122c818d5,1,1,2
676,2021-08-09 15:34:40+01:00,test_quota_model.py,nova\tests,100b9dc62c0ec9f7b38739837c06646122c818d5,1,1,2
677,2021-08-09 15:34:40+01:00,test_quotas.py,nova\tests,100b9dc62c0ec9f7b38739837c06646122c818d5,2,2,4
678,2021-08-09 15:34:40+01:00,test_security_group.py,nova\tests,100b9dc62c0ec9f7b38739837c06646122c818d5,1,1,2
679,2021-08-09 15:34:40+01:00,integrated_helpers.py,nova\tests,100b9dc62c0ec9f7b38739837c06646122c818d5,1,1,2
680,2021-08-09 15:34:40+01:00,test_service.py,nova\tests,100b9dc62c0ec9f7b38739837c06646122c818d5,3,3,6
681,2021-08-09 15:34:40+01:00,test_bug_1764556.py,nova\tests,100b9dc62c0ec9f7b38739837c06646122c818d5,1,1,2
682,2021-08-09 15:34:40+01:00,test_bug_1778305.py,nova\tests,100b9dc62c0ec9f7b38739837c06646122c818d5,1,1,2
683,2021-08-09 15:34:40+01:00,test_bug_1825034.py,nova\tests,100b9dc62c0ec9f7b38739837c06646122c818d5,1,1,2
684,2021-08-09 15:34:40+01:00,test_bug_1839560.py,nova\tests,100b9dc62c0ec9f7b38739837c06646122c818d5,1,1,2
685,2021-08-09 15:34:40+01:00,test_cross_cell_migrate.py,nova\tests,100b9dc62c0ec9f7b38739837c06646122c818d5,1,1,2
686,2021-08-09 15:34:40+01:00,test_server_group.py,nova\tests,100b9dc62c0ec9f7b38739837c06646122c818d5,3,4,7
687,2021-08-09 15:34:40+01:00,test_availability_zone.py,nova\tests,100b9dc62c0ec9f7b38739837c06646122c818d5,1,1,2
688,2021-08-09 15:34:40+01:00,test_disk_config.py,nova\tests,100b9dc62c0ec9f7b38739837c06646122c818d5,1,1,2
689,2021-08-09 15:34:40+01:00,test_hosts.py,nova\tests,100b9dc62c0ec9f7b38739837c06646122c818d5,4,4,8
690,2021-08-09 15:34:40+01:00,test_hypervisors.py,nova\tests,100b9dc62c0ec9f7b38739837c06646122c818d5,1,1,2
691,2021-08-09 15:34:40+01:00,test_instance_actions.py,nova\tests,100b9dc62c0ec9f7b38739837c06646122c818d5,16,11,27
692,2021-08-09 15:34:40+01:00,test_instance_usage_audit_log.py,nova\tests,100b9dc62c0ec9f7b38739837c06646122c818d5,6,4,10
693,2021-08-09 15:34:40+01:00,test_keypairs.py,nova\tests,100b9dc62c0ec9f7b38739837c06646122c818d5,9,9,18
694,2021-08-09 15:34:40+01:00,test_security_groups.py,nova\tests,100b9dc62c0ec9f7b38739837c06646122c818d5,2,2,4
695,2021-08-09 15:34:40+01:00,test_server_actions.py,nova\tests,100b9dc62c0ec9f7b38739837c06646122c818d5,6,4,10
696,2021-08-09 15:34:40+01:00,test_server_metadata.py,nova\tests,100b9dc62c0ec9f7b38739837c06646122c818d5,36,36,72
697,2021-08-09 15:34:40+01:00,test_server_start_stop.py,nova\tests,100b9dc62c0ec9f7b38739837c06646122c818d5,2,2,4
698,2021-08-09 15:34:40+01:00,test_server_tags.py,nova\tests,100b9dc62c0ec9f7b38739837c06646122c818d5,15,15,30
699,2021-08-09 15:34:40+01:00,test_servers.py,nova\tests,100b9dc62c0ec9f7b38739837c06646122c818d5,20,16,36
700,2021-08-09 15:34:40+01:00,test_services.py,nova\tests,100b9dc62c0ec9f7b38739837c06646122c818d5,3,3,6
701,2021-08-09 15:34:40+01:00,fakes.py,nova\tests,100b9dc62c0ec9f7b38739837c06646122c818d5,6,4,10
702,2021-08-09 15:34:40+01:00,test_wsgi_app.py,nova\tests,100b9dc62c0ec9f7b38739837c06646122c818d5,1,1,2
703,2021-08-09 15:34:40+01:00,test_common.py,nova\tests,100b9dc62c0ec9f7b38739837c06646122c818d5,0,11,11
704,2021-08-09 15:34:40+01:00,test_compute.py,nova\tests,100b9dc62c0ec9f7b38739837c06646122c818d5,6,5,11
705,2021-08-09 15:34:40+01:00,test_manage.py,nova\tests,100b9dc62c0ec9f7b38739837c06646122c818d5,8,8,16
706,2021-08-09 15:34:40+01:00,test_policy.py,nova\tests,100b9dc62c0ec9f7b38739837c06646122c818d5,1,1,2
707,2021-08-09 15:34:40+01:00,test_api.py,nova\tests,100b9dc62c0ec9f7b38739837c06646122c818d5,2,2,4
708,2021-08-09 15:34:40+01:00,test_claims.py,nova\tests,100b9dc62c0ec9f7b38739837c06646122c818d5,2,2,4
709,2021-08-09 15:34:40+01:00,test_compute.py,nova\tests,100b9dc62c0ec9f7b38739837c06646122c818d5,40,37,77
710,2021-08-09 15:34:40+01:00,test_compute_mgr.py,nova\tests,100b9dc62c0ec9f7b38739837c06646122c818d5,3,3,6
711,2021-08-09 15:34:40+01:00,test_host_api.py,nova\tests,100b9dc62c0ec9f7b38739837c06646122c818d5,9,8,17
712,2021-08-09 15:34:40+01:00,test_instance_list.py,nova\tests,100b9dc62c0ec9f7b38739837c06646122c818d5,2,2,4
713,2021-08-09 15:34:40+01:00,test_keypairs.py,nova\tests,100b9dc62c0ec9f7b38739837c06646122c818d5,5,5,10
714,2021-08-09 15:34:40+01:00,test_shelve.py,nova\tests,100b9dc62c0ec9f7b38739837c06646122c818d5,1,1,2
715,2021-08-09 15:34:40+01:00,test_cross_cell_migrate.py,nova\tests,100b9dc62c0ec9f7b38739837c06646122c818d5,1,1,2
716,2021-08-09 15:34:40+01:00,test_conductor.py,nova\tests,100b9dc62c0ec9f7b38739837c06646122c818d5,2,3,5
717,2021-08-09 15:34:40+01:00,__init__.py,nova\tests,100b9dc62c0ec9f7b38739837c06646122c818d5,0,0,0
718,2021-08-09 15:34:40+01:00,test_api.py,nova\tests,100b9dc62c0ec9f7b38739837c06646122c818d5,191,159,350
719,2021-08-09 15:34:40+01:00,test_migration.py,nova\tests,100b9dc62c0ec9f7b38739837c06646122c818d5,1,1,2
720,2021-08-09 15:34:40+01:00,test_migrations.py,nova\tests,100b9dc62c0ec9f7b38739837c06646122c818d5,1,1,2
721,2021-08-09 15:34:40+01:00,test_models.py,nova\tests,100b9dc62c0ec9f7b38739837c06646122c818d5,1,1,2
722,2021-08-09 15:34:40+01:00,fake_network.py,nova\tests,100b9dc62c0ec9f7b38739837c06646122c818d5,3,2,5
723,2021-08-09 15:34:40+01:00,fake_server_actions.py,nova\tests,100b9dc62c0ec9f7b38739837c06646122c818d5,4,2,6
724,2021-08-09 15:34:40+01:00,test_neutron.py,nova\tests,100b9dc62c0ec9f7b38739837c06646122c818d5,1,1,2
725,2021-08-09 15:34:40+01:00,test_notification.py,nova\tests,100b9dc62c0ec9f7b38739837c06646122c818d5,1,1,2
726,2021-08-09 15:34:40+01:00,test_service.py,nova\tests,100b9dc62c0ec9f7b38739837c06646122c818d5,4,4,8
727,2021-08-09 15:34:40+01:00,test_bandwidth_usage.py,nova\tests,100b9dc62c0ec9f7b38739837c06646122c818d5,1,1,2
728,2021-08-09 15:34:40+01:00,test_block_device.py,nova\tests,100b9dc62c0ec9f7b38739837c06646122c818d5,7,7,14
729,2021-08-09 15:34:40+01:00,test_compute_node.py,nova\tests,100b9dc62c0ec9f7b38739837c06646122c818d5,21,17,38
730,2021-08-09 15:34:40+01:00,test_console_auth_token.py,nova\tests,100b9dc62c0ec9f7b38739837c06646122c818d5,7,7,14
731,2021-08-09 15:34:40+01:00,test_ec2.py,nova\tests,100b9dc62c0ec9f7b38739837c06646122c818d5,1,1,2
732,2021-08-09 15:34:40+01:00,test_flavor.py,nova\tests,100b9dc62c0ec9f7b38739837c06646122c818d5,1,1,2
733,2021-08-09 15:34:40+01:00,test_instance.py,nova\tests,100b9dc62c0ec9f7b38739837c06646122c818d5,21,21,42
734,2021-08-09 15:34:40+01:00,test_instance_action.py,nova\tests,100b9dc62c0ec9f7b38739837c06646122c818d5,3,3,6
735,2021-08-09 15:34:40+01:00,test_instance_device_metadata.py,nova\tests,100b9dc62c0ec9f7b38739837c06646122c818d5,1,1,2
736,2021-08-09 15:34:40+01:00,test_instance_fault.py,nova\tests,100b9dc62c0ec9f7b38739837c06646122c818d5,2,2,4
737,2021-08-09 15:34:40+01:00,test_instance_info_cache.py,nova\tests,100b9dc62c0ec9f7b38739837c06646122c818d5,1,1,2
738,2021-08-09 15:34:40+01:00,test_instance_numa.py,nova\tests,100b9dc62c0ec9f7b38739837c06646122c818d5,3,3,6
739,2021-08-09 15:34:40+01:00,test_instance_pci_requests.py,nova\tests,100b9dc62c0ec9f7b38739837c06646122c818d5,1,1,2
740,2021-08-09 15:34:40+01:00,test_keypair.py,nova\tests,100b9dc62c0ec9f7b38739837c06646122c818d5,8,8,16
741,2021-08-09 15:34:40+01:00,test_migration.py,nova\tests,100b9dc62c0ec9f7b38739837c06646122c818d5,6,6,12
742,2021-08-09 15:34:40+01:00,test_migration_context.py,nova\tests,100b9dc62c0ec9f7b38739837c06646122c818d5,3,3,6
743,2021-08-09 15:34:40+01:00,test_pci_device.py,nova\tests,100b9dc62c0ec9f7b38739837c06646122c818d5,6,7,13
744,2021-08-09 15:34:40+01:00,test_quotas.py,nova\tests,100b9dc62c0ec9f7b38739837c06646122c818d5,17,16,33
745,2021-08-09 15:34:40+01:00,test_resource.py,nova\tests,100b9dc62c0ec9f7b38739837c06646122c818d5,1,1,2
746,2021-08-09 15:34:40+01:00,test_security_group.py,nova\tests,100b9dc62c0ec9f7b38739837c06646122c818d5,1,1,2
747,2021-08-09 15:34:40+01:00,test_service.py,nova\tests,100b9dc62c0ec9f7b38739837c06646122c818d5,13,13,26
748,2021-08-09 15:34:40+01:00,test_tag.py,nova\tests,100b9dc62c0ec9f7b38739837c06646122c818d5,6,6,12
749,2021-08-09 15:34:40+01:00,test_task_log.py,nova\tests,100b9dc62c0ec9f7b38739837c06646122c818d5,4,4,8
750,2021-08-09 15:34:40+01:00,test_trusted_certs.py,nova\tests,100b9dc62c0ec9f7b38739837c06646122c818d5,1,1,2
751,2021-08-09 15:34:40+01:00,test_virtual_interface.py,nova\tests,100b9dc62c0ec9f7b38739837c06646122c818d5,1,1,2
752,2021-08-09 15:34:40+01:00,test_volume_usage.py,nova\tests,100b9dc62c0ec9f7b38739837c06646122c818d5,4,2,6
753,2021-08-09 15:34:40+01:00,test_manager.py,nova\tests,100b9dc62c0ec9f7b38739837c06646122c818d5,4,4,8
754,2021-08-09 15:34:40+01:00,test_server_tags.py,nova\tests,100b9dc62c0ec9f7b38739837c06646122c818d5,3,3,6
755,2021-08-09 15:34:40+01:00,test_availability_zones.py,nova\tests,100b9dc62c0ec9f7b38739837c06646122c818d5,1,1,2
756,2021-08-09 15:34:40+01:00,test_conf.py,nova\tests,100b9dc62c0ec9f7b38739837c06646122c818d5,1,1,2
757,2021-08-09 15:34:40+01:00,test_context.py,nova\tests,100b9dc62c0ec9f7b38739837c06646122c818d5,3,3,6
758,2021-08-09 15:34:40+01:00,test_fixtures.py,nova\tests,100b9dc62c0ec9f7b38739837c06646122c818d5,1,1,2
759,2021-08-09 15:34:40+01:00,test_metadata.py,nova\tests,100b9dc62c0ec9f7b38739837c06646122c818d5,3,2,5
760,2021-08-09 15:34:40+01:00,test_quota.py,nova\tests,100b9dc62c0ec9f7b38739837c06646122c818d5,12,12,24
761,2021-08-09 15:34:40+01:00,test_test_utils.py,nova\tests,100b9dc62c0ec9f7b38739837c06646122c818d5,1,1,2
762,2021-08-09 15:34:40+01:00,utils.py,nova\tests,100b9dc62c0ec9f7b38739837c06646122c818d5,1,1,2
763,2021-08-09 15:34:40+01:00,test_driver.py,nova\tests,100b9dc62c0ec9f7b38739837c06646122c818d5,1,1,2
764,2021-08-09 15:34:40+01:00,driver.py,nova\virt,100b9dc62c0ec9f7b38739837c06646122c818d5,3,3,6
765,2021-08-09 15:34:40+01:00,driver.py,nova\virt,100b9dc62c0ec9f7b38739837c06646122c818d5,7,7,14
766,2021-08-09 15:34:40+01:00,drop-database-use_db_reconnect-opt-7e0062d3da76032a.yaml,releasenotes\notes,100b9dc62c0ec9f7b38739837c06646122c818d5,9,0,9
767,2021-08-09 15:34:40+01:00,generate-schemas,tools,100b9dc62c0ec9f7b38739837c06646122c818d5,1,1,2
768,2021-08-09 15:34:40+01:00,database.py,nova\conf,aec2ca94686f016c343cc4b97c2e310bb135fd27,7,2,9
769,2021-08-09 15:34:40+01:00,upgrade.rst,doc\source,bf8b5fc7d05e0a66031a03e50e8f6bb76a921046,1,1,2
770,2021-08-09 15:34:40+01:00,README,nova\db,bf8b5fc7d05e0a66031a03e50e8f6bb76a921046,0,0,0
771,2021-08-09 15:34:40+01:00,__init__.py,nova\db,bf8b5fc7d05e0a66031a03e50e8f6bb76a921046,0,0,0
772,2021-08-09 15:34:40+01:00,manage.py,nova\db,bf8b5fc7d05e0a66031a03e50e8f6bb76a921046,0,0,0
773,2021-08-09 15:34:40+01:00,migrate.cfg,nova\db,bf8b5fc7d05e0a66031a03e50e8f6bb76a921046,0,0,0
774,2021-08-09 15:34:40+01:00,067_train.py,nova\db,bf8b5fc7d05e0a66031a03e50e8f6bb76a921046,1,1,2
775,2021-08-09 15:34:40+01:00,068_placeholder.py,nova\db,bf8b5fc7d05e0a66031a03e50e8f6bb76a921046,0,0,0
776,2021-08-09 15:34:40+01:00,069_placeholder.py,nova\db,bf8b5fc7d05e0a66031a03e50e8f6bb76a921046,0,0,0
777,2021-08-09 15:34:40+01:00,070_placeholder.py,nova\db,bf8b5fc7d05e0a66031a03e50e8f6bb76a921046,0,0,0
778,2021-08-09 15:34:40+01:00,071_placeholder.py,nova\db,bf8b5fc7d05e0a66031a03e50e8f6bb76a921046,0,0,0
779,2021-08-09 15:34:40+01:00,072_placeholder.py,nova\db,bf8b5fc7d05e0a66031a03e50e8f6bb76a921046,0,0,0
780,2021-08-09 15:34:40+01:00,073_placeholder.py,nova\db,bf8b5fc7d05e0a66031a03e50e8f6bb76a921046,0,0,0
781,2021-08-09 15:34:40+01:00,074_placeholder.py,nova\db,bf8b5fc7d05e0a66031a03e50e8f6bb76a921046,0,0,0
782,2021-08-09 15:34:40+01:00,075_placeholder.py,nova\db,bf8b5fc7d05e0a66031a03e50e8f6bb76a921046,0,0,0
783,2021-08-09 15:34:40+01:00,076_placeholder.py,nova\db,bf8b5fc7d05e0a66031a03e50e8f6bb76a921046,0,0,0
784,2021-08-09 15:34:40+01:00,077_placeholder.py,nova\db,bf8b5fc7d05e0a66031a03e50e8f6bb76a921046,0,0,0
785,2021-08-09 15:34:40+01:00,078_placeholder.py,nova\db,bf8b5fc7d05e0a66031a03e50e8f6bb76a921046,0,0,0
786,2021-08-09 15:34:40+01:00,079_placeholder.py,nova\db,bf8b5fc7d05e0a66031a03e50e8f6bb76a921046,0,0,0
787,2021-08-09 15:34:40+01:00,080_placeholder.py,nova\db,bf8b5fc7d05e0a66031a03e50e8f6bb76a921046,0,0,0
788,2021-08-09 15:34:40+01:00,081_placeholder.py,nova\db,bf8b5fc7d05e0a66031a03e50e8f6bb76a921046,0,0,0
789,2021-08-09 15:34:40+01:00,082_placeholder.py,nova\db,bf8b5fc7d05e0a66031a03e50e8f6bb76a921046,0,0,0
790,2021-08-09 15:34:40+01:00,083_placeholder.py,nova\db,bf8b5fc7d05e0a66031a03e50e8f6bb76a921046,0,0,0
791,2021-08-09 15:34:40+01:00,084_placeholder.py,nova\db,bf8b5fc7d05e0a66031a03e50e8f6bb76a921046,0,0,0
792,2021-08-09 15:34:40+01:00,085_placeholder.py,nova\db,bf8b5fc7d05e0a66031a03e50e8f6bb76a921046,0,0,0
793,2021-08-09 15:34:40+01:00,086_placeholder.py,nova\db,bf8b5fc7d05e0a66031a03e50e8f6bb76a921046,0,0,0
794,2021-08-09 15:34:40+01:00,087_placeholder.py,nova\db,bf8b5fc7d05e0a66031a03e50e8f6bb76a921046,0,0,0
795,2021-08-09 15:34:40+01:00,__init__.py,nova\db,bf8b5fc7d05e0a66031a03e50e8f6bb76a921046,0,0,0
796,2021-08-09 15:34:40+01:00,models.py,nova\db,bf8b5fc7d05e0a66031a03e50e8f6bb76a921046,0,0,0
797,2021-08-09 15:34:40+01:00,migration.py,nova\db,bf8b5fc7d05e0a66031a03e50e8f6bb76a921046,1,3,4
798,2021-08-09 15:34:40+01:00,__init__.py,nova\db,bf8b5fc7d05e0a66031a03e50e8f6bb76a921046,0,0,0
799,2021-08-09 15:34:40+01:00,__init__.py,nova\db,bf8b5fc7d05e0a66031a03e50e8f6bb76a921046,0,0,0
800,2021-08-09 15:34:40+01:00,aggregate.py,nova\objects,bf8b5fc7d05e0a66031a03e50e8f6bb76a921046,1,1,2
801,2021-08-09 15:34:40+01:00,build_request.py,nova\objects,bf8b5fc7d05e0a66031a03e50e8f6bb76a921046,1,1,2
802,2021-08-09 15:34:40+01:00,cell_mapping.py,nova\objects,bf8b5fc7d05e0a66031a03e50e8f6bb76a921046,1,1,2
803,2021-08-09 15:34:40+01:00,flavor.py,nova\objects,bf8b5fc7d05e0a66031a03e50e8f6bb76a921046,1,1,2
804,2021-08-09 15:34:40+01:00,host_mapping.py,nova\objects,bf8b5fc7d05e0a66031a03e50e8f6bb76a921046,1,1,2
805,2021-08-09 15:34:40+01:00,instance_group.py,nova\objects,bf8b5fc7d05e0a66031a03e50e8f6bb76a921046,1,1,2
806,2021-08-09 15:34:40+01:00,instance_mapping.py,nova\objects,bf8b5fc7d05e0a66031a03e50e8f6bb76a921046,1,1,2
807,2021-08-09 15:34:40+01:00,keypair.py,nova\objects,bf8b5fc7d05e0a66031a03e50e8f6bb76a921046,1,1,2
808,2021-08-09 15:34:40+01:00,quotas.py,nova\objects,bf8b5fc7d05e0a66031a03e50e8f6bb76a921046,1,1,2
809,2021-08-09 15:34:40+01:00,request_spec.py,nova\objects,bf8b5fc7d05e0a66031a03e50e8f6bb76a921046,1,1,2
810,2021-08-09 15:34:40+01:00,quota.py,nova,bf8b5fc7d05e0a66031a03e50e8f6bb76a921046,1,1,2
811,2021-08-09 15:34:40+01:00,test_migrations.py,nova\tests,bf8b5fc7d05e0a66031a03e50e8f6bb76a921046,4,4,8
812,2021-08-09 15:34:40+01:00,test_aggregate.py,nova\tests,bf8b5fc7d05e0a66031a03e50e8f6bb76a921046,4,3,7
813,2021-08-09 15:34:40+01:00,test_aggregate_model.py,nova\tests,bf8b5fc7d05e0a66031a03e50e8f6bb76a921046,1,1,2
814,2021-08-09 15:34:40+01:00,test_flavor.py,nova\tests,bf8b5fc7d05e0a66031a03e50e8f6bb76a921046,1,1,2
815,2021-08-09 15:34:40+01:00,test_flavor_model.py,nova\tests,bf8b5fc7d05e0a66031a03e50e8f6bb76a921046,1,1,2
816,2021-08-09 15:34:40+01:00,test_instance_group.py,nova\tests,bf8b5fc7d05e0a66031a03e50e8f6bb76a921046,1,1,2
817,2021-08-09 15:34:40+01:00,test_quota_model.py,nova\tests,bf8b5fc7d05e0a66031a03e50e8f6bb76a921046,1,1,2
818,2021-08-09 15:34:40+01:00,test_conductor.py,nova\tests,bf8b5fc7d05e0a66031a03e50e8f6bb76a921046,1,1,2
819,2021-08-09 15:34:40+01:00,test_migrations.py,nova\tests,bf8b5fc7d05e0a66031a03e50e8f6bb76a921046,1,4,5
820,2021-08-09 15:34:40+01:00,test_models.py,nova\tests,bf8b5fc7d05e0a66031a03e50e8f6bb76a921046,1,1,2
821,2021-08-09 15:34:40+01:00,test_flavor.py,nova\tests,bf8b5fc7d05e0a66031a03e50e8f6bb76a921046,2,2,4
822,2021-08-09 15:34:40+01:00,reserve-migrations.py,tools,bf8b5fc7d05e0a66031a03e50e8f6bb76a921046,1,1,2
823,2021-08-09 15:34:40+01:00,status.py,nova\cmd,43b253cd60bd68bce108969d6b3adc0565b8f95e,4,3,7
824,2021-08-09 15:34:40+01:00,api.py,nova\compute,43b253cd60bd68bce108969d6b3adc0565b8f95e,6,5,11
825,2021-08-09 15:34:40+01:00,config.py,nova,43b253cd60bd68bce108969d6b3adc0565b8f95e,4,2,6
826,2021-08-09 15:34:40+01:00,api.py,nova\db,43b253cd60bd68bce108969d6b3adc0565b8f95e,50,0,50
827,2021-08-09 15:34:40+01:00,api.py,nova\db,43b253cd60bd68bce108969d6b3adc0565b8f95e,16,116,132
828,2021-08-09 15:34:40+01:00,migration.py,nova\db,43b253cd60bd68bce108969d6b3adc0565b8f95e,4,3,7
829,2021-08-09 15:34:40+01:00,utils.py,nova\db,43b253cd60bd68bce108969d6b3adc0565b8f95e,109,0,109
830,2021-08-09 15:34:40+01:00,aggregate.py,nova\objects,43b253cd60bd68bce108969d6b3adc0565b8f95e,14,14,28
831,2021-08-09 15:34:40+01:00,build_request.py,nova\objects,43b253cd60bd68bce108969d6b3adc0565b8f95e,9,8,17
832,2021-08-09 15:34:40+01:00,cell_mapping.py,nova\objects,43b253cd60bd68bce108969d6b3adc0565b8f95e,23,23,46
833,2021-08-09 15:34:40+01:00,flavor.py,nova\objects,43b253cd60bd68bce108969d6b3adc0565b8f95e,16,15,31
834,2021-08-09 15:34:40+01:00,host_mapping.py,nova\objects,43b253cd60bd68bce108969d6b3adc0565b8f95e,7,7,14
835,2021-08-09 15:34:40+01:00,instance_group.py,nova\objects,43b253cd60bd68bce108969d6b3adc0565b8f95e,13,13,26
836,2021-08-09 15:34:40+01:00,instance_mapping.py,nova\objects,43b253cd60bd68bce108969d6b3adc0565b8f95e,14,14,28
837,2021-08-09 15:34:40+01:00,keypair.py,nova\objects,43b253cd60bd68bce108969d6b3adc0565b8f95e,13,11,24
838,2021-08-09 15:34:40+01:00,quotas.py,nova\objects,43b253cd60bd68bce108969d6b3adc0565b8f95e,54,45,99
839,2021-08-09 15:34:40+01:00,request_spec.py,nova\objects,43b253cd60bd68bce108969d6b3adc0565b8f95e,6,6,12
840,2021-08-09 15:34:40+01:00,virtual_interface.py,nova\objects,43b253cd60bd68bce108969d6b3adc0565b8f95e,24,21,45
841,2021-08-09 15:34:40+01:00,quota.py,nova,43b253cd60bd68bce108969d6b3adc0565b8f95e,7,3,10
842,2021-08-09 15:34:40+01:00,nova.py,nova\tests,43b253cd60bd68bce108969d6b3adc0565b8f95e,26,16,42
843,2021-08-09 15:34:40+01:00,test_aggregate.py,nova\tests,43b253cd60bd68bce108969d6b3adc0565b8f95e,5,5,10
844,2021-08-09 15:34:40+01:00,test_flavor.py,nova\tests,43b253cd60bd68bce108969d6b3adc0565b8f95e,2,2,4
845,2021-08-09 15:34:40+01:00,test_wsgi_app.py,nova\tests,43b253cd60bd68bce108969d6b3adc0565b8f95e,8,4,12
846,2021-08-09 15:34:40+01:00,test_conductor.py,nova\tests,43b253cd60bd68bce108969d6b3adc0565b8f95e,5,4,9
847,2021-08-09 15:34:40+01:00,__init__.py,nova\tests,43b253cd60bd68bce108969d6b3adc0565b8f95e,0,0,0
848,2021-08-09 15:34:40+01:00,test_api.py,nova\tests,43b253cd60bd68bce108969d6b3adc0565b8f95e,24,0,24
849,2021-08-09 15:34:40+01:00,test_api.py,nova\tests,43b253cd60bd68bce108969d6b3adc0565b8f95e,12,126,138
850,2021-08-09 15:34:40+01:00,test_migration.py,nova\tests,43b253cd60bd68bce108969d6b3adc0565b8f95e,9,6,15
851,2021-08-09 15:34:40+01:00,test_utils.py,nova\tests,43b253cd60bd68bce108969d6b3adc0565b8f95e,123,0,123
852,2021-08-09 15:34:40+01:00,test_flavor.py,nova\tests,43b253cd60bd68bce108969d6b3adc0565b8f95e,2,2,4
853,2021-08-09 15:34:40+01:00,test_conf.py,nova\tests,43b253cd60bd68bce108969d6b3adc0565b8f95e,9,4,13
854,2021-08-09 15:34:40+01:00,test_fixtures.py,nova\tests,43b253cd60bd68bce108969d6b3adc0565b8f95e,8,7,15
855,2021-08-09 15:34:40+01:00,402_train.py,nova\db,21c5ced0ba3219d396b354f5fdca629950c63e0c,68,59,127
856,2021-08-09 15:34:40+01:00,alembic.ini,nova\db,ca9ba88a7a31e6feb906f9c84b47af2aed43c684,89,0,89
857,2021-08-09 15:34:40+01:00,402_train.py,nova\db,ca9ba88a7a31e6feb906f9c84b47af2aed43c684,0,3,3
858,2021-08-09 15:34:40+01:00,README.rst,nova\db,ca9ba88a7a31e6feb906f9c84b47af2aed43c684,15,0,15
859,2021-08-09 15:34:40+01:00,env.py,nova\db,ca9ba88a7a31e6feb906f9c84b47af2aed43c684,79,0,79
860,2021-08-09 15:34:40+01:00,script.py.mako,nova\db,ca9ba88a7a31e6feb906f9c84b47af2aed43c684,36,0,36
861,2021-08-09 15:34:40+01:00,8f2f1571d55b_initial_version.py,nova\db,ca9ba88a7a31e6feb906f9c84b47af2aed43c684,1629,0,1629
862,2021-08-09 15:34:40+01:00,alembic.ini,nova\db,38a022166fc1f9df4a02d3746da7092dd4a6186d,89,0,89
863,2021-08-09 15:34:40+01:00,README.rst,nova\db,38a022166fc1f9df4a02d3746da7092dd4a6186d,15,0,15
864,2021-08-09 15:34:40+01:00,env.py,nova\db,38a022166fc1f9df4a02d3746da7092dd4a6186d,80,0,80
865,2021-08-09 15:34:40+01:00,script.py.mako,nova\db,38a022166fc1f9df4a02d3746da7092dd4a6186d,36,0,36
866,2021-08-09 15:34:40+01:00,d67eeaabee36_initial_version.py,nova\db,38a022166fc1f9df4a02d3746da7092dd4a6186d,603,0,603
867,2021-08-09 15:34:40+01:00,manage.py,nova\cmd,c3e113eb31283614e391b46ec596c479add6bbf5,19,12,31
868,2021-08-09 15:34:40+01:00,test_migrations.py,nova\tests,c3e113eb31283614e391b46ec596c479add6bbf5,20,14,34
869,2021-08-09 15:34:40+01:00,test_migrations.py,nova\tests,307adc5e087d06a3ba4ae09dffb973ba83015049,46,39,85
870,2021-08-09 15:34:40+01:00,test_migrations.py,nova\tests,307adc5e087d06a3ba4ae09dffb973ba83015049,122,103,225
871,2021-08-09 15:34:40+01:00,nova-manage.rst,doc\source,905c9723e9b8398010c57b3609310315a913bef1,16,0,16
872,2021-08-09 15:34:40+01:00,alembic.ini,nova\db,905c9723e9b8398010c57b3609310315a913bef1,1,1,2
873,2021-08-09 15:34:40+01:00,env.py,nova\db,905c9723e9b8398010c57b3609310315a913bef1,21,7,28
874,2021-08-09 15:34:40+01:00,models.py,nova\db,905c9723e9b8398010c57b3609310315a913bef1,2,0,2
875,2021-08-09 15:34:40+01:00,alembic.ini,nova\db,905c9723e9b8398010c57b3609310315a913bef1,1,1,2
876,2021-08-09 15:34:40+01:00,api.py,nova\db,905c9723e9b8398010c57b3609310315a913bef1,7,2,9
877,2021-08-09 15:34:40+01:00,env.py,nova\db,905c9723e9b8398010c57b3609310315a913bef1,21,7,28
878,2021-08-09 15:34:40+01:00,migration.py,nova\db,905c9723e9b8398010c57b3609310315a913bef1,133,92,225
879,2021-08-09 15:34:40+01:00,test_migrations.py,nova\tests,905c9723e9b8398010c57b3609310315a913bef1,90,45,135
880,2021-08-09 15:34:40+01:00,test_migrations.py,nova\tests,905c9723e9b8398010c57b3609310315a913bef1,92,67,159
881,2021-08-09 15:34:40+01:00,test_migration.py,nova\tests,905c9723e9b8398010c57b3609310315a913bef1,198,120,318
882,2021-08-09 15:34:40+01:00,switch-to-alembic-ed5c64f62b6c91a3.yaml,releasenotes\notes,905c9723e9b8398010c57b3609310315a913bef1,25,0,25
883,2021-08-09 15:34:40+01:00,067_train.py,nova\db,1ba2c1c55d7d11cca28cac6a4e269009cf8b5032,4,4,8
884,2021-08-09 15:34:40+01:00,script.py.mako,nova\db,1ba2c1c55d7d11cca28cac6a4e269009cf8b5032,0,4,4
885,2021-08-09 15:34:40+01:00,d67eeaabee36_initial_version.py,nova\db,1ba2c1c55d7d11cca28cac6a4e269009cf8b5032,4,4,8
886,2021-08-09 15:34:40+01:00,models.py,nova\db,1ba2c1c55d7d11cca28cac6a4e269009cf8b5032,38,41,79
887,2021-08-09 15:34:40+01:00,402_train.py,nova\db,1ba2c1c55d7d11cca28cac6a4e269009cf8b5032,9,17,26
888,2021-08-09 15:34:40+01:00,env.py,nova\db,1ba2c1c55d7d11cca28cac6a4e269009cf8b5032,20,2,22
889,2021-08-09 15:34:40+01:00,script.py.mako,nova\db,1ba2c1c55d7d11cca28cac6a4e269009cf8b5032,0,4,4
890,2021-08-09 15:34:40+01:00,8f2f1571d55b_initial_version.py,nova\db,1ba2c1c55d7d11cca28cac6a4e269009cf8b5032,9,17,26
891,2021-08-09 15:34:40+01:00,models.py,nova\db,1ba2c1c55d7d11cca28cac6a4e269009cf8b5032,13,17,30
892,2021-08-09 15:34:40+01:00,types.py,nova\db,1ba2c1c55d7d11cca28cac6a4e269009cf8b5032,21,8,29
893,2021-08-09 15:34:40+01:00,test_migrations.py,nova\tests,1ba2c1c55d7d11cca28cac6a4e269009cf8b5032,1,1,2
894,2021-08-09 15:34:40+01:00,test_models.py,nova\tests,1ba2c1c55d7d11cca28cac6a4e269009cf8b5032,3,2,5
895,2021-08-09 15:34:40+01:00,test_flavor.py,nova\tests,1ba2c1c55d7d11cca28cac6a4e269009cf8b5032,4,2,6
896,2021-08-11 17:46:14+00:00,tox.ini,,1e02c81721ec15737cfd9d5e62831da030cc22ad,1,2,3
897,2021-08-11 19:51:14+01:00,test_compute.py,nova\tests,d102b751b743b5315557cac0997198152c0cac74,26,19,45
898,2021-08-11 19:51:14+01:00,driver.py,nova\virt,d102b751b743b5315557cac0997198152c0cac74,1,0,1
899,2021-08-11 19:51:14+01:00,fake.py,nova\virt,d102b751b743b5315557cac0997198152c0cac74,4,0,4
900,2021-08-11 19:51:19+01:00,cinder.py,nova\tests,268b7169554f871d3813d78e79861934d086484d,39,18,57
901,2021-08-11 19:51:19+01:00,test_bug_1939545.py,nova\tests,268b7169554f871d3813d78e79861934d086484d,110,0,110
902,2021-08-11 19:52:12+01:00,manager.py,nova\compute,962eda94d52321c3237da870c3d0455c6f0e851b,8,0,8
903,2021-08-11 19:52:12+01:00,test_bug_1939545.py,nova\tests,962eda94d52321c3237da870c3d0455c6f0e851b,3,3,6
904,2021-08-11 19:52:12+01:00,test_compute_mgr.py,nova\tests,962eda94d52321c3237da870c3d0455c6f0e851b,7,0,7
905,2021-08-11 19:52:12+01:00,base.py,nova\tests,79ec4e2938615a7524fd4c7c05cddeee8256f4a3,1,0,1
906,2021-08-11 19:52:12+01:00,test_numa_live_migration.py,nova\tests,79ec4e2938615a7524fd4c7c05cddeee8256f4a3,0,3,3
907,2021-08-11 19:52:12+01:00,test_pci_sriov_servers.py,nova\tests,79ec4e2938615a7524fd4c7c05cddeee8256f4a3,0,1,1
908,2021-08-11 19:52:12+01:00,test_bug_1939545.py,nova\tests,79ec4e2938615a7524fd4c7c05cddeee8256f4a3,0,4,4
909,2021-08-12 09:03:22+01:00,os_brick.py,nova\tests,ce128798f54d1c0ee7ab09b8189eda93830cd69b,21,0,21
910,2021-08-12 09:03:22+01:00,test_bug_1939545.py,nova\tests,ce128798f54d1c0ee7ab09b8189eda93830cd69b,1,13,14
911,2021-08-12 09:55:02+01:00,cinder.py,nova\tests,d4cc10d7bbc1448ae8a38da63ebe2ee8c3243d30,22,12,34
912,2021-08-12 10:18:43+01:00,test_live_migration.py,nova\tests,31bedfc09c1d35242e0b8101343f6e64ac63157d,72,10,82
913,2021-08-12 14:26:45+01:00,test_bug_1853009.py,nova\tests,59d9871e8a0672538f8ffc43ae99b3d1c4b08909,190,0,190
914,2021-08-12 14:26:45+01:00,manager.py,nova\compute,32676a9f45807ea8770dc7bdff1e859673af1b61,2,0,2
915,2021-08-12 14:26:45+01:00,resource_tracker.py,nova\compute,32676a9f45807ea8770dc7bdff1e859673af1b61,17,0,17
916,2021-08-12 14:26:45+01:00,test_bug_1853009.py,nova\tests,32676a9f45807ea8770dc7bdff1e859673af1b61,26,16,42
917,2021-08-12 14:26:45+01:00,test_compute_mgr.py,nova\tests,32676a9f45807ea8770dc7bdff1e859673af1b61,4,2,6
918,2021-08-12 14:26:45+01:00,test_resource_tracker.py,nova\tests,32676a9f45807ea8770dc7bdff1e859673af1b61,17,0,17
919,2021-08-12 14:26:45+01:00,resource_tracker.py,nova\compute,2bb4527228c8e6fa4a1fa6cfbe80e8790e4e0789,1,0,1
920,2021-08-12 14:26:45+01:00,report.py,nova\scheduler,2bb4527228c8e6fa4a1fa6cfbe80e8790e4e0789,12,5,17
921,2021-08-12 14:26:45+01:00,test_bug_1853009.py,nova\tests,2bb4527228c8e6fa4a1fa6cfbe80e8790e4e0789,6,13,19
922,2021-08-12 14:26:45+01:00,test_resource_tracker.py,nova\tests,2bb4527228c8e6fa4a1fa6cfbe80e8790e4e0789,6,2,8
923,2021-08-17 10:25:20+08:00,accelerator-support.rst,api-guide\source,2226ec4e3b9ecbd070f1545e40063ede1f1aa44a,54,0,54
924,2021-08-17 13:49:18+01:00,.htaccess,doc\source,a7584ec1a5fd0737cb56eb2901aed667f0e49394,2,1,3
925,2021-08-17 13:49:18+01:00,index.rst,doc\source,a7584ec1a5fd0737cb56eb2901aed667f0e49394,1,0,1
926,2021-08-17 13:49:18+01:00,upgrades.rst,doc\source,a7584ec1a5fd0737cb56eb2901aed667f0e49394,53,74,127
927,2021-08-17 13:49:18+01:00,index.rst,doc\source,a7584ec1a5fd0737cb56eb2901aed667f0e49394,2,2,4
928,2021-08-17 13:49:18+01:00,database-migrations.rst,doc\source,a7584ec1a5fd0737cb56eb2901aed667f0e49394,187,0,187
929,2021-08-17 13:49:18+01:00,index.rst,doc\source,a7584ec1a5fd0737cb56eb2901aed667f0e49394,3,0,3
930,2021-08-17 13:49:18+01:00,upgrade-checks.rst,doc\source,a7584ec1a5fd0737cb56eb2901aed667f0e49394,96,86,182
931,2021-08-17 13:49:18+01:00,index.rst,doc\source,a7584ec1a5fd0737cb56eb2901aed667f0e49394,0,3,3
932,2021-08-17 13:49:18+01:00,redirect-tests.txt,doc\test,a7584ec1a5fd0737cb56eb2901aed667f0e49394,2,1,3
933,2021-08-17 13:50:19+01:00,lower-constraints.txt,,eb728e877adc9ba9a6bc362b1db7893f15f44551,2,2,4
934,2021-08-17 13:50:19+01:00,requirements.txt,,eb728e877adc9ba9a6bc362b1db7893f15f44551,2,5,7
935,2021-08-17 13:50:19+01:00,schema_diff.py,tools\db,eb728e877adc9ba9a6bc362b1db7893f15f44551,0,283,283
936,2021-08-17 13:50:19+01:00,generate-schemas,tools,eb728e877adc9ba9a6bc362b1db7893f15f44551,0,123,123
937,2021-08-17 13:50:19+01:00,reserve-migrations.py,tools,eb728e877adc9ba9a6bc362b1db7893f15f44551,0,75,75
938,2021-08-17 13:50:19+01:00,tox.ini,,eb728e877adc9ba9a6bc362b1db7893f15f44551,2,12,14
939,2021-08-17 13:50:19+01:00,nova.py,nova\tests,20d8554f648f21274af2cccd2ffeb25e074d453a,7,0,7
940,2021-08-17 13:57:50+00:00,test_driver.py,nova\tests,39f0af5d18d6bea34fa15b8f7778115b25432749,21,6,27
941,2021-08-17 13:57:50+00:00,driver.py,nova\virt,39f0af5d18d6bea34fa15b8f7778115b25432749,12,0,12
942,2021-08-18 10:54:42+02:00,test_driver_api.py,nova\tests,d31b26e09d469748f2ae2cc1e5f6f57401834adc,1,1,2
943,2021-08-18 10:54:42+02:00,test_ds_util.py,nova\tests,d31b26e09d469748f2ae2cc1e5f6f57401834adc,14,14,28
944,2021-08-18 10:54:42+02:00,test_ds_util_datastore_selection.py,nova\tests,d31b26e09d469748f2ae2cc1e5f6f57401834adc,10,12,22
945,2021-08-18 10:54:42+02:00,ds_util.py,nova\virt,d31b26e09d469748f2ae2cc1e5f6f57401834adc,45,46,91
946,2021-08-18 10:54:42+02:00,vm_util.py,nova\virt,d31b26e09d469748f2ae2cc1e5f6f57401834adc,19,30,49
947,2021-08-18 10:54:42+02:00,vmops.py,nova\virt,d31b26e09d469748f2ae2cc1e5f6f57401834adc,4,6,10
948,2021-08-18 09:51:04-03:00,test_vif.py,nova\tests,7fc6fe6fae891eae42b36ccb9d69cd0f6d6db21d,36,16,52
949,2021-08-18 09:51:04-03:00,vif.py,nova\virt,7fc6fe6fae891eae42b36ccb9d69cd0f6d6db21d,2,1,3
950,2021-08-18 09:51:04-03:00,bug-1939604-547c729b7741831b.yaml,releasenotes\notes,7fc6fe6fae891eae42b36ccb9d69cd0f6d6db21d,5,0,5
951,2021-08-18 15:01:27+02:00,test_vm_util.py,nova\tests,1f2aa3e9d83219a2f504907c2ff02a04aefde7d6,3,8,11
952,2021-08-18 15:01:27+02:00,vif.py,nova\virt,1f2aa3e9d83219a2f504907c2ff02a04aefde7d6,0,2,2
953,2021-08-18 15:01:27+02:00,vm_util.py,nova\virt,1f2aa3e9d83219a2f504907c2ff02a04aefde7d6,3,25,28
954,2021-08-18 15:01:27+02:00,vmops.py,nova\virt,1f2aa3e9d83219a2f504907c2ff02a04aefde7d6,5,15,20
955,2021-08-18 15:01:27+02:00,volumeops.py,nova\virt,1f2aa3e9d83219a2f504907c2ff02a04aefde7d6,7,19,26
956,2021-08-18 15:47:02+02:00,fake.py,nova\tests,3f548f313673e7b0b08e8a4f9d5f149a056ab341,4,2,6
957,2021-08-18 15:47:02+02:00,test_driver_api.py,nova\tests,3f548f313673e7b0b08e8a4f9d5f149a056ab341,1,1,2
958,2021-08-19 11:16:59+01:00,aggregates.py,nova\api,b543f8226c751d0a357b5c4e42bae68186e1b28c,2,2,4
959,2021-08-19 11:16:59+01:00,evacuate.py,nova\api,b543f8226c751d0a357b5c4e42bae68186e1b28c,1,1,2
960,2021-08-19 11:16:59+01:00,hypervisors.py,nova\api,b543f8226c751d0a357b5c4e42bae68186e1b28c,1,1,2
961,2021-08-19 11:16:59+01:00,migrate_server.py,nova\api,b543f8226c751d0a357b5c4e42bae68186e1b28c,1,1,2
962,2021-08-19 11:16:59+01:00,servers.py,nova\api,b543f8226c751d0a357b5c4e42bae68186e1b28c,2,2,4
963,2021-08-19 11:16:59+01:00,services.py,nova\api,b543f8226c751d0a357b5c4e42bae68186e1b28c,2,2,4
964,2021-08-19 11:16:59+01:00,parameter_types.py,nova\api,b543f8226c751d0a357b5c4e42bae68186e1b28c,1,8,9
965,2021-08-19 11:16:59+01:00,test_api_validation.py,nova\tests,b543f8226c751d0a357b5c4e42bae68186e1b28c,4,48,52
966,2021-08-19 11:16:59+01:00,ips.py,nova\api,0942163c829d79495223a91580c3fe7f43d67ccb,2,6,8
967,2021-08-19 11:16:59+01:00,addresses.py,nova\api,0942163c829d79495223a91580c3fe7f43d67ccb,8,6,14
968,2021-08-19 11:16:59+01:00,servers.py,nova\api,0942163c829d79495223a91580c3fe7f43d67ccb,5,2,7
969,2021-08-19 11:16:59+01:00,servers.py,nova\api,e3fa6859f953cd5ee7371f26ec78c6eb244d96b2,56,65,121
970,2021-08-19 11:16:59+01:00,servers.py,nova\api,e3fa6859f953cd5ee7371f26ec78c6eb244d96b2,21,21,42
971,2021-08-19 11:21:55+01:00,test_servers.py,nova\tests,cb3e11952d1933aa25e302323d6d92de4dfd0247,91,91,182
972,2021-08-19 11:21:55+01:00,test_api.py,nova\tests,cb3e11952d1933aa25e302323d6d92de4dfd0247,18,30,48
973,2021-08-19 11:21:55+01:00,test_compute.py,nova\tests,cb3e11952d1933aa25e302323d6d92de4dfd0247,0,11,11
974,2021-08-19 13:23:28+01:00,cinder.py,nova\tests,8a0ae569efbed7c9ef6379fb9b4631c889096944,9,0,9
975,2021-08-20 13:07:14+01:00,base.py,nova\tests,78cace1ce485b2fccb66288eef5d0a13f0f84bde,25,0,25
976,2021-08-20 13:07:14+01:00,test_numa_live_migration.py,nova\tests,78cace1ce485b2fccb66288eef5d0a13f0f84bde,12,12,24
977,2021-08-20 13:07:14+01:00,test_bug_1939545.py,nova\tests,78cace1ce485b2fccb66288eef5d0a13f0f84bde,3,17,20
978,2021-08-20 13:26:46+01:00,block-device-structs.rst,doc\source,b11e3f1d0da238543cb8a3b6c3e00c6b98e99910,15,12,27
979,2021-08-20 13:26:46+01:00,block_device.py,nova,b11e3f1d0da238543cb8a3b6c3e00c6b98e99910,0,24,24
980,2021-08-20 13:26:46+01:00,manager.py,nova\compute,b11e3f1d0da238543cb8a3b6c3e00c6b98e99910,0,22,22
981,2021-08-20 13:26:46+01:00,test_compute.py,nova\tests,b11e3f1d0da238543cb8a3b6c3e00c6b98e99910,0,1,1
982,2021-08-20 13:26:46+01:00,test_block_device.py,nova\tests,b11e3f1d0da238543cb8a3b6c3e00c6b98e99910,0,39,39
983,2021-08-20 13:26:46+01:00,test_driver.py,nova\tests,b11e3f1d0da238543cb8a3b6c3e00c6b98e99910,0,4,4
984,2021-08-20 13:26:46+01:00,test_block_device.py,nova\tests,b11e3f1d0da238543cb8a3b6c3e00c6b98e99910,0,59,59
985,2021-08-20 13:26:46+01:00,test_driver_api.py,nova\tests,b11e3f1d0da238543cb8a3b6c3e00c6b98e99910,0,3,3
986,2021-08-20 13:26:46+01:00,block_device.py,nova\virt,b11e3f1d0da238543cb8a3b6c3e00c6b98e99910,13,40,53
987,2021-08-20 13:26:46+01:00,driver.py,nova\virt,b11e3f1d0da238543cb8a3b6c3e00c6b98e99910,0,10,10
988,2021-08-20 13:26:46+01:00,fake.py,nova\virt,b11e3f1d0da238543cb8a3b6c3e00c6b98e99910,0,4,4
989,2021-08-20 13:26:46+01:00,driver.py,nova\virt,b11e3f1d0da238543cb8a3b6c3e00c6b98e99910,0,4,4
990,2021-08-20 13:26:46+01:00,driver.py,nova\virt,b11e3f1d0da238543cb8a3b6c3e00c6b98e99910,0,4,4
991,2021-08-20 13:26:46+01:00,driver.py,nova\virt,b11e3f1d0da238543cb8a3b6c3e00c6b98e99910,0,4,4
992,2021-08-20 13:26:46+01:00,driver.py,nova\virt,b11e3f1d0da238543cb8a3b6c3e00c6b98e99910,0,4,4
993,2021-08-20 13:35:53+01:00,workarounds.py,nova\conf,ec48e1523dfdd0f1031e1a70c28c56962db66e8a,10,0,10
994,2021-08-20 13:35:53+01:00,test_driver.py,nova\tests,ec48e1523dfdd0f1031e1a70c28c56962db66e8a,31,0,31
995,2021-08-20 13:35:53+01:00,driver.py,nova\virt,ec48e1523dfdd0f1031e1a70c28c56962db66e8a,2,1,3
996,2021-08-20 13:35:53+01:00,libvirt-disable-apic-39599bdc2d110a1f.yaml,releasenotes\notes,ec48e1523dfdd0f1031e1a70c28c56962db66e8a,13,0,13
997,2021-08-20 14:57:45+01:00,manager.py,nova\compute,a8492e88783b40f6dc61888fada232f0d00d6acf,23,10,33
998,2021-08-20 14:57:45+01:00,api.py,nova\db,a8492e88783b40f6dc61888fada232f0d00d6acf,18,5,23
999,2021-08-20 14:57:45+01:00,compute_node.py,nova\objects,a8492e88783b40f6dc61888fada232f0d00d6acf,14,1,15
1000,2021-08-20 14:57:45+01:00,test_bug_1853009.py,nova\tests,a8492e88783b40f6dc61888fada232f0d00d6acf,18,7,25
1001,2021-08-20 14:57:45+01:00,test_compute.py,nova\tests,a8492e88783b40f6dc61888fada232f0d00d6acf,2,1,3
1002,2021-08-20 14:57:45+01:00,test_compute_mgr.py,nova\tests,a8492e88783b40f6dc61888fada232f0d00d6acf,27,0,27
1003,2021-08-20 14:57:45+01:00,test_api.py,nova\tests,a8492e88783b40f6dc61888fada232f0d00d6acf,7,0,7
1004,2021-08-20 14:57:45+01:00,test_compute_node.py,nova\tests,a8492e88783b40f6dc61888fada232f0d00d6acf,11,1,12
1005,2021-08-20 14:57:45+01:00,bug-1853009-99414e14d1491b5f.yaml,releasenotes\notes,a8492e88783b40f6dc61888fada232f0d00d6acf,7,0,7
1006,2021-08-20 14:57:47+01:00,api.py,nova\db,2383cbb4a518821d245fce316b3778c8ba8e5246,15,2,17
1007,2021-08-20 14:57:47+01:00,test_bug_1853009.py,nova\tests,2383cbb4a518821d245fce316b3778c8ba8e5246,0,33,33
1008,2021-08-20 14:57:47+01:00,test_api.py,nova\tests,2383cbb4a518821d245fce316b3778c8ba8e5246,16,0,16
1009,2021-08-21 09:38:44+02:00,test_nova_manage.py,nova\tests,1039aa64435341938013ad599356fca1b7b47a4a,2,2,4
1010,2021-08-21 09:38:44+02:00,test_servers.py,nova\tests,1039aa64435341938013ad599356fca1b7b47a4a,0,2388,2388
1011,2021-08-21 09:38:44+02:00,test_servers_resource_request.py,nova\tests,1039aa64435341938013ad599356fca1b7b47a4a,2428,0,2428
1012,2021-08-21 09:38:46+02:00,integrated_helpers.py,nova\tests,713a11727dd6cd4722587a61bc46e213a6c29059,4,0,4
1013,2021-08-21 09:38:46+02:00,test_servers_resource_request.py,nova\tests,713a11727dd6cd4722587a61bc46e213a6c29059,15,6,21
1014,2021-08-21 09:48:35+02:00,neutron.py,nova\tests,aa3d89b31fcabda1b4e41516c630c0a50976f9eb,0,62,62
1015,2021-08-21 09:48:35+02:00,test_servers_resource_request.py,nova\tests,aa3d89b31fcabda1b4e41516c630c0a50976f9eb,85,16,101
1016,2021-08-21 09:48:37+02:00,constants.py,nova\network,f68d30bff3d8cccf758547807bf7db02dbba34ee,1,0,1
1017,2021-08-21 09:48:37+02:00,test_servers_resource_request.py,nova\tests,f68d30bff3d8cccf758547807bf7db02dbba34ee,107,0,107
1018,2021-08-21 09:48:37+02:00,constants.py,nova\network,017b0a3d2332b1d3d20c2aa51ae9605f6c7676ee,1,0,1
1019,2021-08-21 09:48:37+02:00,neutron.py,nova\network,017b0a3d2332b1d3d20c2aa51ae9605f6c7676ee,15,0,15
1020,2021-08-21 09:48:37+02:00,test_neutron.py,nova\tests,017b0a3d2332b1d3d20c2aa51ae9605f6c7676ee,65,0,65
1021,2021-08-21 09:49:54+02:00,port_with_resource_request.rst,api-guide\source,e357ad3c2354f1c22cd5b569a2f0ec23c9c06753,10,0,10
1022,2021-08-21 09:49:54+02:00,ports-with-resource-requests.rst,doc\source,e357ad3c2354f1c22cd5b569a2f0ec23c9c06753,25,0,25
1023,2021-08-21 09:49:54+02:00,servers.py,nova\api,e357ad3c2354f1c22cd5b569a2f0ec23c9c06753,3,1,4
1024,2021-08-21 09:49:54+02:00,exception.py,nova,e357ad3c2354f1c22cd5b569a2f0ec23c9c06753,6,0,6
1025,2021-08-21 09:49:54+02:00,neutron.py,nova\network,e357ad3c2354f1c22cd5b569a2f0ec23c9c06753,14,1,15
1026,2021-08-21 09:49:54+02:00,test_servers_resource_request.py,nova\tests,e357ad3c2354f1c22cd5b569a2f0ec23c9c06753,35,0,35
1027,2021-08-21 09:49:54+02:00,test_neutron.py,nova\tests,e357ad3c2354f1c22cd5b569a2f0ec23c9c06753,35,5,40
1028,2021-08-21 10:00:48+02:00,evacuate.py,nova\api,8f5b7c67ca9fc528dfedf89c5f74cb067229e6e0,7,0,7
1029,2021-08-21 10:00:48+02:00,migrate_server.py,nova\api,8f5b7c67ca9fc528dfedf89c5f74cb067229e6e0,14,0,14
1030,2021-08-21 10:00:48+02:00,servers.py,nova\api,8f5b7c67ca9fc528dfedf89c5f74cb067229e6e0,9,0,9
1031,2021-08-21 10:00:48+02:00,shelve.py,nova\api,8f5b7c67ca9fc528dfedf89c5f74cb067229e6e0,13,0,13
1032,2021-08-21 10:00:48+02:00,api.py,nova\compute,8f5b7c67ca9fc528dfedf89c5f74cb067229e6e0,18,0,18
1033,2021-08-21 10:00:48+02:00,exception.py,nova,8f5b7c67ca9fc528dfedf89c5f74cb067229e6e0,7,0,7
1034,2021-08-21 10:00:48+02:00,neutron.py,nova\network,8f5b7c67ca9fc528dfedf89c5f74cb067229e6e0,24,0,24
1035,2021-08-21 10:00:48+02:00,test_servers_resource_request.py,nova\tests,8f5b7c67ca9fc528dfedf89c5f74cb067229e6e0,92,5,97
1036,2021-08-21 10:00:48+02:00,test_evacuate.py,nova\tests,8f5b7c67ca9fc528dfedf89c5f74cb067229e6e0,7,0,7
1037,2021-08-21 10:00:48+02:00,test_migrate_server.py,nova\tests,8f5b7c67ca9fc528dfedf89c5f74cb067229e6e0,7,0,7
1038,2021-08-21 10:00:48+02:00,test_server_actions.py,nova\tests,8f5b7c67ca9fc528dfedf89c5f74cb067229e6e0,7,0,7
1039,2021-08-21 10:00:48+02:00,test_shelve.py,nova\tests,8f5b7c67ca9fc528dfedf89c5f74cb067229e6e0,7,0,7
1040,2021-08-21 10:00:48+02:00,test_api.py,nova\tests,8f5b7c67ca9fc528dfedf89c5f74cb067229e6e0,4,0,4
1041,2021-08-21 10:00:48+02:00,test_neutron.py,nova\tests,8f5b7c67ca9fc528dfedf89c5f74cb067229e6e0,80,0,80
1042,2021-08-21 10:00:48+02:00,base.py,nova\tests,8f5b7c67ca9fc528dfedf89c5f74cb067229e6e0,1,0,1
1043,2021-08-21 10:00:51+02:00,request_spec.py,nova\objects,9de8bfb6e61ebb9776f8027eb9c334044c7bc8bd,40,1,41
1044,2021-08-21 10:00:51+02:00,test_objects.py,nova\tests,9de8bfb6e61ebb9776f8027eb9c334044c7bc8bd,1,1,2
1045,2021-08-21 10:00:51+02:00,test_request_spec.py,nova\tests,9de8bfb6e61ebb9776f8027eb9c334044c7bc8bd,51,0,51
1046,2021-08-21 10:00:51+02:00,nova-status.rst,doc\source,f6e8c512fbce7c8ab2444c6a31132dc461f5638b,4,0,4
1047,2021-08-21 10:00:51+02:00,status.py,nova\cmd,f6e8c512fbce7c8ab2444c6a31132dc461f5638b,4,4,8
1048,2021-08-21 10:00:51+02:00,report.py,nova\scheduler,f6e8c512fbce7c8ab2444c6a31132dc461f5638b,2,2,4
1049,2021-08-21 10:00:51+02:00,test_report_client.py,nova\tests,f6e8c512fbce7c8ab2444c6a31132dc461f5638b,1,1,2
1050,2021-08-21 10:00:51+02:00,test_report.py,nova\tests,f6e8c512fbce7c8ab2444c6a31132dc461f5638b,3,3,6
1051,2021-08-21 10:00:51+02:00,require-placemnet-api-microversion-1.36-1129fe4afc949075.yaml,releasenotes\notes,f6e8c512fbce7c8ab2444c6a31132dc461f5638b,7,0,7
1052,2021-08-21 10:00:51+02:00,request_spec.py,nova\objects,b29ccf8aa5cf2081ed46ac53741a8600ae40f071,7,0,7
1053,2021-08-21 10:00:51+02:00,utils.py,nova\scheduler,b29ccf8aa5cf2081ed46ac53741a8600ae40f071,5,0,5
1054,2021-08-21 10:00:51+02:00,test_utils.py,nova\tests,b29ccf8aa5cf2081ed46ac53741a8600ae40f071,22,0,22
1055,2021-08-21 10:00:51+02:00,test_servers_resource_request.py,nova\tests,c9b1dfe9b7a57fcd07212cb7deedf0b91ccb88cc,72,89,161
1056,2021-08-21 10:00:51+02:00,test_servers_resource_request.py,nova\tests,de9b136dc6aaea600f53a21f5e3303b92210d88e,167,134,301
1057,2021-08-21 10:00:51+02:00,test_servers_resource_request.py,nova\tests,ec6f8f63f9c03d4572a7ad59f940c4dd7cf3ba66,284,1,285
1058,2021-08-21 17:19:36+09:00,nova-config-generator.conf,etc\nova,9bae5f2ca5f5780beb09130ece9ea77da1f6ab83,1,0,1
1059,2021-08-21 10:25:00+02:00,neutron.py,nova\network,d6cd4420bb33501e267b10ccc3a1f26ab2c8c85b,22,7,29
1060,2021-08-21 10:25:00+02:00,request_spec.py,nova\objects,d6cd4420bb33501e267b10ccc3a1f26ab2c8c85b,48,0,48
1061,2021-08-21 10:25:00+02:00,test_servers_resource_request.py,nova\tests,d6cd4420bb33501e267b10ccc3a1f26ab2c8c85b,0,20,20
1062,2021-08-21 10:25:00+02:00,test_neutron.py,nova\tests,d6cd4420bb33501e267b10ccc3a1f26ab2c8c85b,80,1,81
1063,2021-08-21 10:25:00+02:00,test_request_spec.py,nova\tests,d6cd4420bb33501e267b10ccc3a1f26ab2c8c85b,58,0,58
1064,2021-08-22 11:45:17+02:00,api.py,nova\compute,94f47471e058e46441a63d5aaf77776ef75b3fba,14,9,23
1065,2021-08-22 11:45:17+02:00,manager.py,nova\compute,94f47471e058e46441a63d5aaf77776ef75b3fba,14,5,19
1066,2021-08-22 11:45:17+02:00,neutron.py,nova\network,94f47471e058e46441a63d5aaf77776ef75b3fba,16,7,23
1067,2021-08-22 11:45:17+02:00,request_spec.py,nova\objects,94f47471e058e46441a63d5aaf77776ef75b3fba,12,8,20
1068,2021-08-22 11:45:17+02:00,utils.py,nova\scheduler,94f47471e058e46441a63d5aaf77776ef75b3fba,4,0,4
1069,2021-08-22 11:45:17+02:00,fakes.py,nova\tests,94f47471e058e46441a63d5aaf77776ef75b3fba,1,1,2
1070,2021-08-22 11:45:17+02:00,test_api.py,nova\tests,94f47471e058e46441a63d5aaf77776ef75b3fba,43,11,54
1071,2021-08-22 11:45:17+02:00,test_compute.py,nova\tests,94f47471e058e46441a63d5aaf77776ef75b3fba,75,21,96
1072,2021-08-22 11:45:17+02:00,test_compute_mgr.py,nova\tests,94f47471e058e46441a63d5aaf77776ef75b3fba,2,1,3
1073,2021-08-22 11:45:17+02:00,test_neutron.py,nova\tests,94f47471e058e46441a63d5aaf77776ef75b3fba,34,5,39
1074,2021-08-22 11:45:17+02:00,test_request_spec.py,nova\tests,94f47471e058e46441a63d5aaf77776ef75b3fba,8,4,12
1075,2021-08-22 11:45:17+02:00,test_utils.py,nova\tests,94f47471e058e46441a63d5aaf77776ef75b3fba,9,2,11
1076,2021-08-23 15:51:06+01:00,websocketproxy.py,nova\console,6fbd0b758dcac71323f3be179b1a9d1c17a4acc5,1,6,7
1077,2021-08-23 15:51:06+01:00,test_websocketproxy.py,nova\tests,6fbd0b758dcac71323f3be179b1a9d1c17a4acc5,34,0,34
1078,2021-08-23 17:36:00+02:00,test_rbd.py,nova\tests,930b7c992156733fbb4f598488605825d62ebc0c,21,21,42
1079,2021-08-23 16:45:37+01:00,parameters.yaml,api-ref\source,289438b4c28267c8556fe7c69cf52ad9281fd9d0,1,1,2
1080,2021-08-23 16:45:37+01:00,.htaccess,doc\source,289438b4c28267c8556fe7c69cf52ad9281fd9d0,4,2,6
1081,2021-08-23 16:45:37+01:00,index.rst,doc\source,289438b4c28267c8556fe7c69cf52ad9281fd9d0,0,1,1
1082,2021-08-23 16:45:37+01:00,schedulers.rst,doc\source,289438b4c28267c8556fe7c69cf52ad9281fd9d0,0,1050,1050
1083,2021-08-23 16:45:37+01:00,cpu-topologies.rst,doc\source,289438b4c28267c8556fe7c69cf52ad9281fd9d0,1,1,2
1084,2021-08-23 16:45:37+01:00,index.rst,doc\source,289438b4c28267c8556fe7c69cf52ad9281fd9d0,1,0,1
1085,2021-08-23 16:45:37+01:00,scheduling.rst,doc\source,289438b4c28267c8556fe7c69cf52ad9281fd9d0,1416,0,1416
1086,2021-08-23 16:45:37+01:00,virtual-gpu.rst,doc\source,289438b4c28267c8556fe7c69cf52ad9281fd9d0,0,5,5
1087,2021-08-23 16:45:37+01:00,extra-specs.rst,doc\source,289438b4c28267c8556fe7c69cf52ad9281fd9d0,1,1,2
1088,2021-08-23 16:45:37+01:00,eventlet-profiling.rst,doc\source,289438b4c28267c8556fe7c69cf52ad9281fd9d0,1,1,2
1089,2021-08-23 16:45:37+01:00,index.rst,doc\source,289438b4c28267c8556fe7c69cf52ad9281fd9d0,1,2,3
1090,2021-08-23 16:45:37+01:00,scheduler-hints-vs-flavor-extra-specs.rst,doc\source,289438b4c28267c8556fe7c69cf52ad9281fd9d0,1,1,2
1091,2021-08-23 16:45:37+01:00,scheduling.rst,doc\source,289438b4c28267c8556fe7c69cf52ad9281fd9d0,1,1,2
1092,2021-08-23 16:45:37+01:00,filter-scheduler.rst,doc\source,289438b4c28267c8556fe7c69cf52ad9281fd9d0,0,630,630
1093,2021-08-23 16:45:37+01:00,flavors.rst,doc\source,289438b4c28267c8556fe7c69cf52ad9281fd9d0,1,7,8
1094,2021-08-23 16:45:37+01:00,index.rst,doc\source,289438b4c28267c8556fe7c69cf52ad9281fd9d0,1,1,2
1095,2021-08-23 16:45:37+01:00,redirect-tests.txt,doc\test,289438b4c28267c8556fe7c69cf52ad9281fd9d0,4,2,6
1096,2021-08-23 16:52:25+01:00,eventlet-profiling.rst,doc\source,665299949494d78d88ff8c22caa2a4f3978c054b,13,14,27
1097,2021-08-23 16:52:25+01:00,driver.py,nova\scheduler,665299949494d78d88ff8c22caa2a4f3978c054b,0,505,505
1098,2021-08-23 16:52:25+01:00,manager.py,nova\scheduler,665299949494d78d88ff8c22caa2a4f3978c054b,511,61,572
1099,2021-08-23 16:52:25+01:00,test_numa_servers.py,nova\tests,665299949494d78d88ff8c22caa2a4f3978c054b,1,1,2
1100,2021-08-23 16:52:25+01:00,test_pci_sriov_servers.py,nova\tests,665299949494d78d88ff8c22caa2a4f3978c054b,1,1,2
1101,2021-08-23 16:52:25+01:00,test_bug_1781710.py,nova\tests,665299949494d78d88ff8c22caa2a4f3978c054b,4,4,8
1102,2021-08-23 16:52:25+01:00,test_servers.py,nova\tests,665299949494d78d88ff8c22caa2a4f3978c054b,1,1,2
1103,2021-08-23 16:52:25+01:00,test_driver.py,nova\tests,665299949494d78d88ff8c22caa2a4f3978c054b,0,1126,1126
1104,2021-08-23 16:52:25+01:00,test_manager.py,nova\tests,665299949494d78d88ff8c22caa2a4f3978c054b,1139,34,1173
1105,2021-08-23 16:52:28+01:00,test_scheduler_utils.py,nova\tests,62e112461f63d19572c7b8e60a48c6b9fcaf4204,0,519,519
1106,2021-08-23 16:52:28+01:00,test_utils.py,nova\tests,62e112461f63d19572c7b8e60a48c6b9fcaf4204,483,2,485
1107,2021-08-23 16:52:28+01:00,scheduler.py,nova\conf,50a7a3050a2fb746a35330f0544320382373bded,0,22,22
1108,2021-08-23 16:52:28+01:00,remove-deprecated-scheduler-opts-37afb63a94e8b47e.yaml,releasenotes\notes,50a7a3050a2fb746a35330f0544320382373bded,17,0,17
1109,2021-08-23 18:34:52+01:00,test_bug_1938326.py,nova\tests,5e8267f703d040b6e8b56d5c0f3ed669170cbb2d,1,1,2
1110,2021-08-23 18:36:07+01:00,api.py,nova\compute,da6af3fb224d5033980537f8a677437c464c12b1,4,3,7
1111,2021-08-23 18:36:07+01:00,test_bug_1938326.py,nova\tests,da6af3fb224d5033980537f8a677437c464c12b1,4,15,19
1112,2021-08-23 18:36:07+01:00,test_api.py,nova\tests,da6af3fb224d5033980537f8a677437c464c12b1,35,35,70
1113,2021-08-23 18:36:07+01:00,test_compute.py,nova\tests,da6af3fb224d5033980537f8a677437c464c12b1,27,22,49
1114,2021-08-23 18:36:07+01:00,test_servers.py,nova\tests,da6af3fb224d5033980537f8a677437c464c12b1,18,6,24
1115,2021-08-24 08:43:50+02:00,server_groups.py,nova\api,b6ab1cb467c7fb45f49e44323047eb27023452c1,1,1,2
1116,2021-08-24 12:07:41+01:00,os-volume-attachments.inc,api-ref\source,ac21c6674c8444edc5afd25b7d63936182fe3580,11,7,18
1117,2021-08-24 12:07:41+01:00,parameters.yaml,api-ref\source,ac21c6674c8444edc5afd25b7d63936182fe3580,21,6,27
1118,2021-08-24 12:07:41+01:00,attach-volume-to-server-req.json,doc\api_samples,ac21c6674c8444edc5afd25b7d63936182fe3580,7,0,7
1119,2021-08-24 12:07:41+01:00,attach-volume-to-server-resp.json,doc\api_samples,ac21c6674c8444edc5afd25b7d63936182fe3580,10,0,10
1120,2021-08-24 12:07:41+01:00,list-volume-attachments-resp.json,doc\api_samples,ac21c6674c8444edc5afd25b7d63936182fe3580,22,0,22
1121,2021-08-24 12:07:41+01:00,update-volume-attachment-delete-flag-req.json,doc\api_samples,ac21c6674c8444edc5afd25b7d63936182fe3580,10,0,10
1122,2021-08-24 12:07:41+01:00,volume-attachment-detail-resp.json,doc\api_samples,ac21c6674c8444edc5afd25b7d63936182fe3580,11,0,11
1123,2021-08-24 12:07:41+01:00,v21-version-get-resp.json,doc\api_samples,ac21c6674c8444edc5afd25b7d63936182fe3580,1,1,2
1124,2021-08-24 12:07:41+01:00,versions-get-resp.json,doc\api_samples,ac21c6674c8444edc5afd25b7d63936182fe3580,1,1,2
1125,2021-08-24 12:07:41+01:00,api_version_request.py,nova\api,ac21c6674c8444edc5afd25b7d63936182fe3580,5,1,6
1126,2021-08-24 12:07:41+01:00,rest_api_version_history.rst,nova\api,ac21c6674c8444edc5afd25b7d63936182fe3580,11,0,11
1127,2021-08-24 12:07:41+01:00,volumes.py,nova\api,ac21c6674c8444edc5afd25b7d63936182fe3580,52,27,79
1128,2021-08-24 12:07:41+01:00,attach-volume-to-server-req.json.tpl,nova\tests,ac21c6674c8444edc5afd25b7d63936182fe3580,7,0,7
1129,2021-08-24 12:07:41+01:00,attach-volume-to-server-resp.json.tpl,nova\tests,ac21c6674c8444edc5afd25b7d63936182fe3580,10,0,10
1130,2021-08-24 12:07:41+01:00,list-volume-attachments-resp.json.tpl,nova\tests,ac21c6674c8444edc5afd25b7d63936182fe3580,22,0,22
1131,2021-08-24 12:07:41+01:00,update-volume-attachment-delete-flag-req.json.tpl,nova\tests,ac21c6674c8444edc5afd25b7d63936182fe3580,10,0,10
1132,2021-08-24 12:07:41+01:00,update-volume-req.json.tpl,nova\tests,ac21c6674c8444edc5afd25b7d63936182fe3580,5,0,5
1133,2021-08-24 12:07:41+01:00,volume-attachment-detail-resp.json.tpl,nova\tests,ac21c6674c8444edc5afd25b7d63936182fe3580,11,0,11
1134,2021-08-24 12:07:41+01:00,test_volumes.py,nova\tests,ac21c6674c8444edc5afd25b7d63936182fe3580,9,1,10
1135,2021-08-24 12:07:41+01:00,test_volumes.py,nova\tests,ac21c6674c8444edc5afd25b7d63936182fe3580,90,10,100
1136,2021-08-24 12:07:41+01:00,add-attachment-id-to-os-volume-attachments-a23818d5b11f15a1.yaml,releasenotes\notes,ac21c6674c8444edc5afd25b7d63936182fe3580,8,0,8
1137,2021-08-24 13:53:02+02:00,cpu-topologies.rst,doc\source,1d62485472573b8634f23df93c7b28f1c74bf9a5,3,3,6
1138,2021-08-24 19:03:57+01:00,parameters.yaml,api-ref\source,a057bbc40654d99e18b3b69fd93757e76bbbd1fa,4,4,8
1139,2021-08-24 15:56:08-04:00,test_pci_sriov_servers.py,nova\tests,38603a4d09a77882298423a8b20c67b283b99ad0,22,0,22
1140,2021-08-25 16:53:47+08:00,os-cells.inc,api-ref\source,191712594d0dad0a7775a2978557162cb040a345,14,0,14
1141,2021-08-25 10:26:07+01:00,nova-manage.rst,doc\source,e906a8c0ec87b870b0ae75c20cf1d2da36433636,108,0,108
1142,2021-08-25 10:26:07+01:00,manage.py,nova\cmd,e906a8c0ec87b870b0ae75c20cf1d2da36433636,346,38,384
1143,2021-08-25 10:26:07+01:00,instance_actions.py,nova\compute,e906a8c0ec87b870b0ae75c20cf1d2da36433636,4,0,4
1144,2021-08-25 10:26:07+01:00,test_nova_manage.py,nova\tests,e906a8c0ec87b870b0ae75c20cf1d2da36433636,231,1,232
1145,2021-08-25 10:26:07+01:00,test_manage.py,nova\tests,e906a8c0ec87b870b0ae75c20cf1d2da36433636,547,0,547
1146,2021-08-25 10:26:07+01:00,add-nova-manage-bdm-commands-19f360dd85c1e81d.yaml,releasenotes\notes,e906a8c0ec87b870b0ae75c20cf1d2da36433636,16,0,16
1147,2021-08-26 10:54:25+01:00,servers.py,nova\api,cfa33d3b06a279f8f6dc6ad7d76d49feb36b0ace,2,0,2
1148,2021-08-26 10:54:25+01:00,extended_server_attributes.py,nova\policies,cfa33d3b06a279f8f6dc6ad7d76d49feb36b0ace,2,1,3
1149,2021-08-26 10:54:25+01:00,microversion-2-90-59fb6d4ec420b9f4.yaml,releasenotes\notes,cfa33d3b06a279f8f6dc6ad7d76d49feb36b0ace,8,0,8
1150,2021-08-26 16:18:09+02:00,networking.rst,doc\source,fc1a99dc16313eaa001408b08ed68f5f3ebacc49,2,2,4
1151,2021-08-27 13:29:07+01:00,test_driver.py,nova\tests,a543cb23aa30194dfb5d1fbfad4906257deeaf59,63,1,64
1152,2021-08-27 13:29:07+01:00,driver.py,nova\virt,a543cb23aa30194dfb5d1fbfad4906257deeaf59,62,14,76
1153,2021-08-27 13:29:08+01:00,test_driver.py,nova\tests,2b847085c8aa19a8fee9bed471e2b609482f67e7,40,2,42
1154,2021-08-27 13:29:08+01:00,driver.py,nova\virt,2b847085c8aa19a8fee9bed471e2b609482f67e7,14,10,24
1155,2021-08-27 15:51:12+02:00,port_with_resource_request.rst,api-guide\source,c3886c3ca758b32df8a58388d967dc3c0a5aebec,7,2,9
1156,2021-08-27 15:51:12+02:00,ports-with-resource-requests.rst,doc\source,c3886c3ca758b32df8a58388d967dc3c0a5aebec,9,4,13
1157,2021-08-27 15:51:12+02:00,servers.py,nova\api,c3886c3ca758b32df8a58388d967dc3c0a5aebec,1,1,2
1158,2021-08-27 15:51:12+02:00,api.py,nova\compute,c3886c3ca758b32df8a58388d967dc3c0a5aebec,15,1,16
1159,2021-08-27 15:51:12+02:00,exception.py,nova,c3886c3ca758b32df8a58388d967dc3c0a5aebec,3,3,6
1160,2021-08-27 15:51:12+02:00,neutron.py,nova\network,c3886c3ca758b32df8a58388d967dc3c0a5aebec,53,22,75
1161,2021-08-27 15:51:12+02:00,service.py,nova\objects,c3886c3ca758b32df8a58388d967dc3c0a5aebec,4,1,5
1162,2021-08-27 15:51:12+02:00,test_servers_resource_request.py,nova\tests,c3886c3ca758b32df8a58388d967dc3c0a5aebec,22,46,68
1163,2021-08-27 15:51:12+02:00,test_api.py,nova\tests,c3886c3ca758b32df8a58388d967dc3c0a5aebec,1,1,2
1164,2021-08-27 15:51:12+02:00,test_compute.py,nova\tests,c3886c3ca758b32df8a58388d967dc3c0a5aebec,26,0,26
1165,2021-08-27 15:51:12+02:00,test_neutron.py,nova\tests,c3886c3ca758b32df8a58388d967dc3c0a5aebec,197,65,262
1166,2021-08-27 14:52:01+01:00,devices.py,nova\conf,9be996c696e91e82d11d81db72ffb4cc151598b6,13,2,15
1167,2021-08-27 14:52:01+01:00,libvirt.py,nova\tests,9be996c696e91e82d11d81db72ffb4cc151598b6,27,11,38
1168,2021-08-27 14:52:01+01:00,test_reshape.py,nova\tests,9be996c696e91e82d11d81db72ffb4cc151598b6,6,6,12
1169,2021-08-27 14:52:01+01:00,test_vgpu.py,nova\tests,9be996c696e91e82d11d81db72ffb4cc151598b6,205,50,255
1170,2021-08-27 14:52:01+01:00,test_devices.py,nova\tests,9be996c696e91e82d11d81db72ffb4cc151598b6,2,0,2
1171,2021-08-27 14:52:01+01:00,test_driver.py,nova\tests,9be996c696e91e82d11d81db72ffb4cc151598b6,12,4,16
1172,2021-08-27 14:52:01+01:00,driver.py,nova\virt,9be996c696e91e82d11d81db72ffb4cc151598b6,1,3,4
1173,2021-08-27 14:52:01+01:00,generic_mdevs_2-d1b1c71e8035527f.yaml,releasenotes\notes,9be996c696e91e82d11d81db72ffb4cc151598b6,10,0,10
1174,2021-08-27 17:59:18+02:00,port_with_resource_request.rst,api-guide\source,191bdf2069086493be2a2e0351afa7f3efad7099,2,3,5
1175,2021-08-27 17:59:18+02:00,ports-with-resource-requests.rst,doc\source,191bdf2069086493be2a2e0351afa7f3efad7099,2,3,5
1176,2021-08-27 17:59:18+02:00,evacuate.py,nova\api,191bdf2069086493be2a2e0351afa7f3efad7099,1,9,10
1177,2021-08-27 17:59:18+02:00,migrate_server.py,nova\api,191bdf2069086493be2a2e0351afa7f3efad7099,10,20,30
1178,2021-08-27 17:59:18+02:00,servers.py,nova\api,191bdf2069086493be2a2e0351afa7f3efad7099,8,16,24
1179,2021-08-27 17:59:18+02:00,shelve.py,nova\api,191bdf2069086493be2a2e0351afa7f3efad7099,4,16,20
1180,2021-08-27 17:59:18+02:00,api.py,nova\compute,191bdf2069086493be2a2e0351afa7f3efad7099,31,6,37
1181,2021-08-27 17:59:18+02:00,manager.py,nova\conductor,191bdf2069086493be2a2e0351afa7f3efad7099,12,11,23
1182,2021-08-27 17:59:18+02:00,live_migrate.py,nova\conductor,191bdf2069086493be2a2e0351afa7f3efad7099,9,11,20
1183,2021-08-27 17:59:18+02:00,migrate.py,nova\conductor,191bdf2069086493be2a2e0351afa7f3efad7099,5,2,7
1184,2021-08-27 17:59:18+02:00,neutron.py,nova\network,191bdf2069086493be2a2e0351afa7f3efad7099,62,19,81
1185,2021-08-27 17:59:18+02:00,service.py,nova\objects,191bdf2069086493be2a2e0351afa7f3efad7099,5,1,6
1186,2021-08-27 17:59:18+02:00,test_servers_resource_request.py,nova\tests,191bdf2069086493be2a2e0351afa7f3efad7099,61,50,111
1187,2021-08-27 17:59:18+02:00,test_api.py,nova\tests,191bdf2069086493be2a2e0351afa7f3efad7099,58,5,63
1188,2021-08-27 17:59:18+02:00,test_compute.py,nova\tests,191bdf2069086493be2a2e0351afa7f3efad7099,15,0,15
1189,2021-08-27 17:59:18+02:00,test_shelve.py,nova\tests,191bdf2069086493be2a2e0351afa7f3efad7099,19,0,19
1190,2021-08-27 17:59:18+02:00,test_live_migrate.py,nova\tests,191bdf2069086493be2a2e0351afa7f3efad7099,67,4,71
1191,2021-08-27 17:59:18+02:00,test_migrate.py,nova\tests,191bdf2069086493be2a2e0351afa7f3efad7099,6,2,8
1192,2021-08-27 17:59:18+02:00,test_conductor.py,nova\tests,191bdf2069086493be2a2e0351afa7f3efad7099,14,6,20
1193,2021-08-27 17:59:18+02:00,test_neutron.py,nova\tests,191bdf2069086493be2a2e0351afa7f3efad7099,303,11,314
1194,2021-08-27 17:06:38+01:00,migration.py,nova\db,cf07df57e7ab8428a2e06940fb6b7952e579dd65,7,17,24
1195,2021-08-27 17:19:05+01:00,migration.py,nova\db,6c5dd864c24bc8cec89dccbff68b63c3bc23ef70,9,4,13
1196,2021-08-27 17:19:05+01:00,test_migration.py,nova\tests,6c5dd864c24bc8cec89dccbff68b63c3bc23ef70,48,2,50
1197,2021-08-30 06:11:25+00:00,manage.py,nova\cmd,c09d98dadb6cd69e294420ba7ecea0f9b9cfcd71,1,1,2
1198,2021-08-30 06:11:25+00:00,api.py,nova\compute,c09d98dadb6cd69e294420ba7ecea0f9b9cfcd71,2,2,4
1199,2021-08-30 06:11:25+00:00,manager.py,nova\compute,c09d98dadb6cd69e294420ba7ecea0f9b9cfcd71,13,7,20
1200,2021-08-30 06:11:25+00:00,resource_tracker.py,nova\compute,c09d98dadb6cd69e294420ba7ecea0f9b9cfcd71,7,3,10
1201,2021-08-30 06:11:25+00:00,manager.py,nova\conductor,c09d98dadb6cd69e294420ba7ecea0f9b9cfcd71,1,1,2
1202,2021-08-30 06:11:25+00:00,report.py,nova\scheduler,c09d98dadb6cd69e294420ba7ecea0f9b9cfcd71,36,5,41
1203,2021-08-30 06:11:25+00:00,manager.py,nova\scheduler,c09d98dadb6cd69e294420ba7ecea0f9b9cfcd71,2,1,3
1204,2021-08-30 06:11:25+00:00,test_report_client.py,nova\tests,c09d98dadb6cd69e294420ba7ecea0f9b9cfcd71,2,2,4
1205,2021-08-30 06:11:25+00:00,test_servers.py,nova\tests,c09d98dadb6cd69e294420ba7ecea0f9b9cfcd71,0,62,62
1206,2021-08-30 06:11:25+00:00,test_compute_mgr.py,nova\tests,c09d98dadb6cd69e294420ba7ecea0f9b9cfcd71,3,1,4
1207,2021-08-30 06:11:25+00:00,test_resource_tracker.py,nova\tests,c09d98dadb6cd69e294420ba7ecea0f9b9cfcd71,3,3,6
1208,2021-08-30 06:11:25+00:00,test_manager.py,nova\tests,c09d98dadb6cd69e294420ba7ecea0f9b9cfcd71,2,2,4
1209,2021-08-31 13:14:19+01:00,test_servers.py,nova\tests,fa35cfa9983e098455d9dfc1daa87f8be4cf57d4,4,1,5
1210,2021-09-01 10:21:51+02:00,test_servers_resource_request.py,nova\tests,9cb92e88321237f5581b2e125136d211bb080a45,12,4,16
1211,2021-09-01 12:26:52+01:00,HACKING.rst,,9f8cc2f03827c10f89ee652bc73790b3c58111d3,3,0,3
1212,2021-09-01 12:26:52+01:00,checks.py,nova\hacking,9f8cc2f03827c10f89ee652bc73790b3c58111d3,62,0,62
1213,2021-09-01 12:26:52+01:00,test_compute.py,nova\tests,9f8cc2f03827c10f89ee652bc73790b3c58111d3,1,1,2
1214,2021-09-01 12:26:52+01:00,test_hacking.py,nova\tests,9f8cc2f03827c10f89ee652bc73790b3c58111d3,66,0,66
1215,2021-09-01 12:26:52+01:00,test_driver.py,nova\tests,9f8cc2f03827c10f89ee652bc73790b3c58111d3,1,1,2
1216,2021-09-01 12:26:52+01:00,tox.ini,,9f8cc2f03827c10f89ee652bc73790b3c58111d3,2,0,2
1217,2021-09-01 12:50:23+01:00,workarounds.py,nova\conf,9bd62eae6eb98136be7014eb6ca7e54cb41fc7ca,0,34,34
1218,2021-09-01 12:50:23+01:00,test_driver.py,nova\tests,9bd62eae6eb98136be7014eb6ca7e54cb41fc7ca,0,72,72
1219,2021-09-01 12:50:23+01:00,driver.py,nova\virt,9bd62eae6eb98136be7014eb6ca7e54cb41fc7ca,0,6,6
1220,2021-09-01 12:50:23+01:00,libvirt-workarounds-disable_native_luksv1-18773636b414970e.yaml,releasenotes\notes,9bd62eae6eb98136be7014eb6ca7e54cb41fc7ca,6,0,6
1221,2021-09-01 12:50:23+01:00,workarounds.py,nova\conf,122a32ed8295ce1168505ed1b6d0f08422c506c4,0,30,30
1222,2021-09-01 12:50:23+01:00,test_net.py,nova\tests,122a32ed8295ce1168505ed1b6d0f08422c506c4,0,46,46
1223,2021-09-01 12:50:23+01:00,net.py,nova\virt,122a32ed8295ce1168505ed1b6d0f08422c506c4,3,37,40
1224,2021-09-01 12:50:23+01:00,libvirt-workarounds-remove-rbd_volume_local_attach-ebdf9cf313344a45.yaml,releasenotes\notes,122a32ed8295ce1168505ed1b6d0f08422c506c4,6,0,6
1225,2021-09-01 15:51:47+02:00,port_with_resource_request.rst,api-guide\source,44309c419ff44dcf91d4905116f51bd5fdb72a96,3,8,11
1226,2021-09-01 15:51:47+02:00,ports-with-resource-requests.rst,doc\source,44309c419ff44dcf91d4905116f51bd5fdb72a96,2,6,8
1227,2021-09-01 15:51:47+02:00,attach_interfaces.py,nova\api,44309c419ff44dcf91d4905116f51bd5fdb72a96,3,1,4
1228,2021-09-01 15:51:47+02:00,api.py,nova\compute,44309c419ff44dcf91d4905116f51bd5fdb72a96,31,25,56
1229,2021-09-01 15:51:47+02:00,manager.py,nova\compute,44309c419ff44dcf91d4905116f51bd5fdb72a96,27,20,47
1230,2021-09-01 15:51:47+02:00,neutron.py,nova\network,44309c419ff44dcf91d4905116f51bd5fdb72a96,19,7,26
1231,2021-09-01 15:51:47+02:00,service.py,nova\objects,44309c419ff44dcf91d4905116f51bd5fdb72a96,5,1,6
1232,2021-09-01 15:51:47+02:00,utils.py,nova\scheduler,44309c419ff44dcf91d4905116f51bd5fdb72a96,9,4,13
1233,2021-09-01 15:51:47+02:00,integrated_helpers.py,nova\tests,44309c419ff44dcf91d4905116f51bd5fdb72a96,3,2,5
1234,2021-09-01 15:51:47+02:00,test_servers_resource_request.py,nova\tests,44309c419ff44dcf91d4905116f51bd5fdb72a96,15,72,87
1235,2021-09-01 15:51:47+02:00,test_api.py,nova\tests,44309c419ff44dcf91d4905116f51bd5fdb72a96,82,0,82
1236,2021-09-01 15:51:47+02:00,test_neutron.py,nova\tests,44309c419ff44dcf91d4905116f51bd5fdb72a96,60,0,60
1237,2021-09-01 15:51:47+02:00,test_utils.py,nova\tests,44309c419ff44dcf91d4905116f51bd5fdb72a96,36,19,55
1238,2021-09-01 15:51:47+02:00,test_servers_resource_request.py,nova\tests,37f80c13c6b10f22536cebc823d0884acbde9512,33,28,61
1239,2021-09-01 09:09:58-05:00,attach_interfaces.py,nova\api,1b6a6e3916806849025f3a90cd6ec48811b02e8a,1,5,6
1240,2021-09-01 09:09:58-05:00,evacuate.py,nova\api,1b6a6e3916806849025f3a90cd6ec48811b02e8a,0,7,7
1241,2021-09-01 09:09:58-05:00,migrate_server.py,nova\api,1b6a6e3916806849025f3a90cd6ec48811b02e8a,1,11,12
1242,2021-09-01 09:09:58-05:00,rescue.py,nova\api,1b6a6e3916806849025f3a90cd6ec48811b02e8a,0,2,2
1243,2021-09-01 09:09:58-05:00,servers.py,nova\api,1b6a6e3916806849025f3a90cd6ec48811b02e8a,3,11,14
1244,2021-09-01 09:09:58-05:00,shelve.py,nova\api,1b6a6e3916806849025f3a90cd6ec48811b02e8a,0,4,4
1245,2021-09-01 09:09:58-05:00,suspend_server.py,nova\api,1b6a6e3916806849025f3a90cd6ec48811b02e8a,1,7,8
1246,2021-09-01 09:09:58-05:00,volumes.py,nova\api,1b6a6e3916806849025f3a90cd6ec48811b02e8a,1,2,3
1247,2021-09-01 09:09:58-05:00,wsgi.py,nova\api,1b6a6e3916806849025f3a90cd6ec48811b02e8a,9,0,9
1248,2021-09-01 09:09:58-05:00,exception.py,nova,1b6a6e3916806849025f3a90cd6ec48811b02e8a,21,13,34
1249,2021-09-01 09:09:58-05:00,test_servers.py,nova\tests,1b6a6e3916806849025f3a90cd6ec48811b02e8a,8,8,16
1250,2021-09-01 09:09:58-05:00,test_attach_interfaces.py,nova\tests,1b6a6e3916806849025f3a90cd6ec48811b02e8a,17,0,17
1251,2021-09-01 09:09:58-05:00,test_evacuate.py,nova\tests,1b6a6e3916806849025f3a90cd6ec48811b02e8a,13,4,17
1252,2021-09-01 09:09:58-05:00,test_migrate_server.py,nova\tests,1b6a6e3916806849025f3a90cd6ec48811b02e8a,15,5,20
1253,2021-09-01 09:09:58-05:00,test_rescue.py,nova\tests,1b6a6e3916806849025f3a90cd6ec48811b02e8a,17,4,21
1254,2021-09-01 09:09:58-05:00,test_server_actions.py,nova\tests,1b6a6e3916806849025f3a90cd6ec48811b02e8a,27,6,33
1255,2021-09-01 09:09:58-05:00,test_shelve.py,nova\tests,1b6a6e3916806849025f3a90cd6ec48811b02e8a,11,9,20
1256,2021-09-01 09:09:58-05:00,test_suspend_server.py,nova\tests,1b6a6e3916806849025f3a90cd6ec48811b02e8a,4,10,14
1257,2021-09-01 09:09:58-05:00,test_volumes.py,nova\tests,1b6a6e3916806849025f3a90cd6ec48811b02e8a,1,1,2
1258,2021-09-01 09:09:58-05:00,test_api.py,nova\tests,1b6a6e3916806849025f3a90cd6ec48811b02e8a,5,5,10
1259,2021-09-01 09:09:58-05:00,convert-features-not-implemented-return-code-bf8beea51705271b.yaml,releasenotes\notes,1b6a6e3916806849025f3a90cd6ec48811b02e8a,8,0,8
1260,2021-09-01 17:32:56+02:00,test_config.py,nova\tests,b67b928c381511f6101778ab50f281ecd689d283,18,0,18
1261,2021-09-01 17:32:56+02:00,test_driver.py,nova\tests,b67b928c381511f6101778ab50f281ecd689d283,11,3,14
1262,2021-09-01 17:32:56+02:00,config.py,nova\virt,b67b928c381511f6101778ab50f281ecd689d283,4,0,4
1263,2021-09-01 18:33:33+02:00,test_vm_util.py,nova\tests,625469d692f0561cffb5cf1b5c1a0e67f221e9f1,4,3,7
1264,2021-09-02 13:55:46+02:00,nova-manage.rst,doc\source,fc77ce191fe9393be815bc32e6da867808dab054,8,2,10
1265,2021-09-02 13:55:46+02:00,manage.py,nova\cmd,fc77ce191fe9393be815bc32e6da867808dab054,19,6,25
1266,2021-09-02 13:55:46+02:00,test_manage.py,nova\tests,fc77ce191fe9393be815bc32e6da867808dab054,11,3,14
1267,2021-09-02 13:55:46+02:00,archive-sleep-a0cc3d3e7784e5df.yaml,releasenotes\notes,fc77ce191fe9393be815bc32e6da867808dab054,11,0,11
1268,2021-09-02 13:09:08+00:00,rpcapi.py,nova\compute,8541f37cb5cf405b07107d1d7c428bbd335e514c,1,0,1
1269,2021-09-02 17:46:22+01:00,ImageMetaPropsPayload.json,doc\notification_samples,c59084397401c690c6b23b5c8631138ec85e8f04,1,1,2
1270,2021-09-02 17:46:22+01:00,image.py,nova\notifications,c59084397401c690c6b23b5c8631138ec85e8f04,2,1,3
1271,2021-09-02 17:46:22+01:00,fields.py,nova\objects,c59084397401c690c6b23b5c8631138ec85e8f04,2,1,3
1272,2021-09-02 17:46:22+01:00,image_meta.py,nova\objects,c59084397401c690c6b23b5c8631138ec85e8f04,9,1,10
1273,2021-09-02 17:46:22+01:00,test_instance.py,nova\tests,c59084397401c690c6b23b5c8631138ec85e8f04,2,2,4
1274,2021-09-02 17:46:22+01:00,test_notification.py,nova\tests,c59084397401c690c6b23b5c8631138ec85e8f04,1,1,2
1275,2021-09-02 17:46:22+01:00,test_image_meta.py,nova\tests,c59084397401c690c6b23b5c8631138ec85e8f04,22,0,22
1276,2021-09-02 17:46:22+01:00,test_objects.py,nova\tests,c59084397401c690c6b23b5c8631138ec85e8f04,1,1,2
1277,2021-09-02 17:46:22+01:00,bochs-ffaa289da97d08c8.yaml,releasenotes\notes,c59084397401c690c6b23b5c8631138ec85e8f04,7,0,7
1278,2021-09-03 11:14:51+08:00,test_driver.py,nova\tests,a6ef502aa06599102ae9a5a86067f3bc4b6440b2,34,7,41
1279,2021-09-03 11:14:51+08:00,test_host.py,nova\tests,a6ef502aa06599102ae9a5a86067f3bc4b6440b2,17,0,17
1280,2021-09-03 11:14:51+08:00,driver.py,nova\virt,a6ef502aa06599102ae9a5a86067f3bc4b6440b2,16,4,20
1281,2021-09-03 11:14:51+08:00,host.py,nova\virt,a6ef502aa06599102ae9a5a86067f3bc4b6440b2,11,7,18
1282,2021-09-03 16:32:53+01:00,manage.py,nova\cmd,bbcd7d2fd03c0717af18f2724c75c1447e430fb1,18,6,24
1283,2021-09-03 16:32:53+01:00,test_manage.py,nova\tests,bbcd7d2fd03c0717af18f2724c75c1447e430fb1,29,8,37
1284,2021-09-06 13:03:22+02:00,port_with_resource_request.rst,api-guide\source,22d4057a1607a08379559f5895cb8d7a11cdb72e,6,5,11
1285,2021-09-06 13:03:22+02:00,ports-with-resource-requests.rst,doc\source,22d4057a1607a08379559f5895cb8d7a11cdb72e,4,4,8
1286,2021-09-07 14:40:12+02:00,test_bug_1938326.py,nova\tests,058d137ac88ecd45bdf4095a31783886cf64f820,11,3,14
1287,2021-09-13 13:55:17+02:00,test_migrations.py,nova\tests,166b1730b81afe446157340a315687580e0f6285,16,0,16
1288,2021-09-13 13:55:17+02:00,test_migrations.py,nova\tests,166b1730b81afe446157340a315687580e0f6285,18,2,20
1289,2021-09-13 14:08:11+02:00,migration.py,nova\db,a3597530069aa7b55b1d3a033f50e0deebcb9786,3,1,4
1290,2021-09-13 14:08:11+02:00,test_migrations.py,nova\tests,a3597530069aa7b55b1d3a033f50e0deebcb9786,3,12,15
1291,2021-09-13 14:08:11+02:00,test_migrations.py,nova\tests,a3597530069aa7b55b1d3a033f50e0deebcb9786,3,12,15
1292,2021-09-13 14:08:11+02:00,test_migration.py,nova\tests,a3597530069aa7b55b1d3a033f50e0deebcb9786,13,11,24
1293,2021-09-15 10:26:39+01:00,manage-volumes.rst,doc\source,70040856aaff069fabab84b64fb0c2858bdb1b7d,143,0,143
1294,2021-09-16 17:25:32+02:00,xena-prelude-515ee8a9e1f71c18.yaml,releasenotes\notes,73d78f01a0d0d20164c3f6b5f3daf1dc2f0bf7a4,43,0,43
1295,2021-09-16 22:07:31+00:00,orphaned-allocations.rst,doc\source,9797b921d0f99bc445c3211db451cf788967d911,35,0,35
1296,2021-09-16 22:07:31+00:00,nova-manage.rst,doc\source,9797b921d0f99bc445c3211db451cf788967d911,2,0,2
1297,2021-09-17 14:44:10+00:00,index.rst,releasenotes\source,0bd61915ee1d96ca339f342a190e395a39afbcf9,1,0,1
1298,2021-09-17 14:44:10+00:00,xena.rst,releasenotes\source,0bd61915ee1d96ca339f342a190e395a39afbcf9,6,0,6
1299,2021-09-17 14:44:22+00:00,.zuul.yaml,,11f95eebea01b0aea7026ea8145b0d8709aed2d7,2,2,4
1300,2021-09-19 11:09:27+09:00,how-to-get-involved.rst,doc\source,a2bedcc6fcb3ced4d8ebaf07fd0922dd41aaf935,2,2,4
1301,2021-09-19 11:09:27+09:00,process.rst,doc\source,a2bedcc6fcb3ced4d8ebaf07fd0922dd41aaf935,5,5,10
1302,2021-09-20 11:28:46+02:00,__init__.py,nova\db,b689beeb92085d2231fe18e4fd47159d8049efba,0,0,0
1303,2021-09-20 11:23:40+00:00,test_cinder.py,nova\tests,f6206269b71d9bcaf65aa0313c21cc6b75a54fb3,24,18,42
1304,2021-09-20 11:23:40+00:00,cinder.py,nova\volume,f6206269b71d9bcaf65aa0313c21cc6b75a54fb3,6,4,10
1305,2021-09-24 11:18:21+01:00,__init__.py,nova\tests,a19821bd6248ff438bd4d9d9b97de8e9a909a288,0,0,0
1306,2021-09-24 11:18:21+01:00,test_migrations.py,nova\tests,a19821bd6248ff438bd4d9d9b97de8e9a909a288,22,6,28
1307,2021-09-24 11:18:21+01:00,test_migrations.py,nova\tests,a19821bd6248ff438bd4d9d9b97de8e9a909a288,23,47,70
1308,2021-09-24 11:18:36+01:00,test_migrations.py,nova\tests,5150704b790fcf00725c4837d6c374533317cc9e,5,12,17
1309,2021-09-24 11:18:36+01:00,test_migrations.py,nova\tests,5150704b790fcf00725c4837d6c374533317cc9e,6,48,54
1310,2021-09-24 11:18:36+01:00,test_migration.py,nova\tests,5150704b790fcf00725c4837d6c374533317cc9e,36,4,40
1311,2021-09-24 13:04:04+02:00,test_numa_servers.py,nova\tests,3e4e4489b7a6e9cdefcc6ff02ed99a0a70420fca,121,0,121
1312,2021-09-24 12:13:44+01:00,nova.py,nova\tests,c8dadf4af84c9d829047fdacbe06ce4f2afea349,3,0,3
1313,2021-09-24 12:13:44+01:00,test_migrations.py,nova\tests,c8dadf4af84c9d829047fdacbe06ce4f2afea349,19,8,27
1314,2021-09-24 12:14:41+01:00,16f1fbcab42b_resolve_shadow_table_diffs.py,nova\db,558196ac46f857070637cc03c5e88df2b37cbb0d,62,0,62
1315,2021-09-24 12:14:41+01:00,8f2f1571d55b_initial_version.py,nova\db,558196ac46f857070637cc03c5e88df2b37cbb0d,15,9,24
1316,2021-09-24 12:14:41+01:00,test_migrations.py,nova\tests,558196ac46f857070637cc03c5e88df2b37cbb0d,31,0,31
1317,2021-09-27 10:20:34+01:00,check-cherry-picks.sh,tools,e07bb310b674fb471a92edf3258e564f05534595,5,0,5
1318,2021-09-27 12:01:20+02:00,manager.py,nova\compute,b841e553214be9a732703e2dfed6c97698ef9b71,12,0,12
1319,2021-09-27 12:01:20+02:00,test_numa_servers.py,nova\tests,b841e553214be9a732703e2dfed6c97698ef9b71,13,27,40
1320,2021-09-28 12:42:44+02:00,neutron.py,nova\tests,6b1e624bed074c4eee529bd03210862657e9b7de,13,0,13
1321,2021-09-28 12:42:44+02:00,test_servers_resource_request.py,nova\tests,6b1e624bed074c4eee529bd03210862657e9b7de,203,0,203
1322,2021-09-29 11:53:02+01:00,manage.py,nova\cmd,d59188d5e2db3d7d33f9da0c2546101747da6423,2,1,3
1323,2021-09-29 11:53:02+01:00,cinder.py,nova\tests,d59188d5e2db3d7d33f9da0c2546101747da6423,6,0,6
1324,2021-09-29 11:53:02+01:00,test_nova_manage.py,nova\tests,d59188d5e2db3d7d33f9da0c2546101747da6423,7,0,7
1325,2021-09-29 11:53:02+01:00,test_manage.py,nova\tests,d59188d5e2db3d7d33f9da0c2546101747da6423,4,2,6
1326,2021-09-30 14:50:45+01:00,cinder.py,nova\tests,674a5e8dca94d2a08970dd701d8066a109b72e2c,54,6,60
1327,2021-09-30 14:50:45+01:00,integrated_helpers.py,nova\tests,674a5e8dca94d2a08970dd701d8066a109b72e2c,20,0,20
1328,2021-09-30 14:50:45+01:00,test_bug_1943431.py,nova\tests,674a5e8dca94d2a08970dd701d8066a109b72e2c,161,0,161
1329,2021-10-01 13:09:02+00:00,service.py,nova\objects,ad227d7085030f95587a4cfed63ef8b6ad2bb84f,2,1,3
1330,2021-10-07 10:45:43+01:00,manager.py,nova\compute,6fd071b904282e106de7488a076d4f703636af21,9,0,9
1331,2021-10-07 10:45:43+01:00,test_bug_1943431.py,nova\tests,6fd071b904282e106de7488a076d4f703636af21,19,29,48
1332,2021-10-07 10:45:43+01:00,test_compute_mgr.py,nova\tests,6fd071b904282e106de7488a076d4f703636af21,8,2,10
1333,2021-10-07 10:45:43+01:00,integrated_helpers.py,nova\tests,9a1cac7110ae759fe3962e7e104c816e904cc27b,23,30,53
1334,2021-10-07 10:45:43+01:00,cinder.py,nova\tests,22e9d22369d34e150855eb1710b371e80d17ebb0,43,81,124
1335,2021-10-07 11:21:51+01:00,.zuul.yaml,,cf4e516f553ccbc4fad6014153d9b51095297607,0,6,6
1336,2021-10-11 07:52:05+00:00,test_migration.py,nova\tests,6a15169ed9f16672c2cde1d7f27178bb7868c41f,42,1,43
1337,2021-10-11 07:52:05+00:00,migration.py,nova\virt,6a15169ed9f16672c2cde1d7f27178bb7868c41f,9,2,11
1338,2021-10-12 18:20:35-05:00,tox.ini,,7b063e4d0518af3e57872bc0288a94edcd33c19d,10,0,10
1339,2021-10-14 09:23:08+03:00,gmr.rst,doc\source,46401ef6665d473b51a781a566a29b7b24eb711f,27,4,31
1340,2021-10-14 09:23:08+03:00,wsgi_app.py,nova\api,46401ef6665d473b51a781a566a29b7b24eb711f,8,2,10
1341,2021-10-14 09:23:08+03:00,uwsgi-gmr-c00631db79836340.yaml,nova\releasenotes,46401ef6665d473b51a781a566a29b7b24eb711f,6,0,6
1342,2021-10-14 18:27:30+02:00,test.py,nova,61fc81a6761d34afdfc4a6d1c4c953802fd8a179,3,0,3
1343,2021-10-14 18:27:30+02:00,notifications.py,nova\tests,61fc81a6761d34afdfc4a6d1c4c953802fd8a179,35,2,37
1344,2021-10-14 18:27:30+02:00,nova.py,nova\tests,61fc81a6761d34afdfc4a6d1c4c953802fd8a179,84,0,84
1345,2021-10-18 20:26:18+01:00,.gitignore,,60b977b76dc113183043840acf98b215441e186d,5,1,6
1346,2021-10-18 20:26:18+01:00,env.py,nova\db,60b977b76dc113183043840acf98b215441e186d,51,7,58
1347,2021-10-18 20:26:18+01:00,env.py,nova\db,60b977b76dc113183043840acf98b215441e186d,16,4,20
1348,2021-10-18 20:26:18+01:00,env.py,nova\db,a4d7f70740b1c707a71ea50f9996c02bf434cf74,14,35,49
1349,2021-10-18 20:26:18+01:00,models.py,nova\db,a4d7f70740b1c707a71ea50f9996c02bf434cf74,45,0,45
1350,2021-10-18 20:26:18+01:00,env.py,nova\db,a4d7f70740b1c707a71ea50f9996c02bf434cf74,15,15,30
1351,2021-10-18 20:26:18+01:00,models.py,nova\db,a4d7f70740b1c707a71ea50f9996c02bf434cf74,21,0,21
1352,2021-10-18 20:26:18+01:00,test_migrations.py,nova\tests,a4d7f70740b1c707a71ea50f9996c02bf434cf74,9,28,37
1353,2021-10-18 20:26:18+01:00,test_migrations.py,nova\tests,a4d7f70740b1c707a71ea50f9996c02bf434cf74,30,23,53
1354,2021-10-18 20:26:18+01:00,b30f573d3377_remove_unused_build_requests_columns.py,nova\db,9657297dd6c63e7a1e0c84c3e943b26f1795d388,45,0,45
1355,2021-10-18 20:26:18+01:00,models.py,nova\db,9657297dd6c63e7a1e0c84c3e943b26f1795d388,1,32,33
1356,2021-10-18 20:26:18+01:00,test_migrations.py,nova\tests,9657297dd6c63e7a1e0c84c3e943b26f1795d388,35,0,35
1357,2021-10-18 20:26:18+01:00,models.py,nova\db,1f648b4f7763e33675d5a16d426fd3d3cd701069,17,230,247
1358,2021-10-18 20:26:18+01:00,api.py,nova\db,944033061c173ea432fa16e9a2d3bafdfc08a308,0,72,72
1359,2021-10-18 20:26:18+01:00,keypair.py,nova\objects,944033061c173ea432fa16e9a2d3bafdfc08a308,20,56,76
1360,2021-10-18 20:26:18+01:00,test_keypair.py,nova\tests,944033061c173ea432fa16e9a2d3bafdfc08a308,58,104,162
1361,2021-10-18 20:26:18+01:00,test_keypairs.py,nova\tests,944033061c173ea432fa16e9a2d3bafdfc08a308,39,46,85
1362,2021-10-18 20:26:18+01:00,fakes.py,nova\tests,944033061c173ea432fa16e9a2d3bafdfc08a308,3,5,8
1363,2021-10-18 20:26:18+01:00,test_keypairs.py,nova\tests,944033061c173ea432fa16e9a2d3bafdfc08a308,9,7,16
1364,2021-10-18 20:26:18+01:00,test_api.py,nova\tests,944033061c173ea432fa16e9a2d3bafdfc08a308,0,196,196
1365,2021-10-18 20:26:18+01:00,test_keypair.py,nova\tests,944033061c173ea432fa16e9a2d3bafdfc08a308,21,88,109
1366,2021-10-19 11:08:41+01:00,test_migrations.py,nova\tests,fb083138eb03ca6de3e90e07a9c603b717e73fbe,8,0,8
1367,2021-10-19 11:08:41+01:00,test_migrations.py,nova\tests,fb083138eb03ca6de3e90e07a9c603b717e73fbe,8,0,8
1368,2021-10-19 16:34:52+02:00,test_shelve.py,nova\tests,78e10f5f14a018fd1d96ea242923631459acb62c,24,0,24
1369,2021-10-20 09:12:02+02:00,manager.py,nova\compute,518b952bdeb6ec29252b56527b8c8d7b32abe1b5,4,0,4
1370,2021-10-20 09:12:02+02:00,test_shelve.py,nova\tests,518b952bdeb6ec29252b56527b8c8d7b32abe1b5,2,6,8
1371,2021-10-20 11:39:23+02:00,api.py,nova\compute,49b481ec98087351ce1366d3afb9f4a79cd16ae3,5,1,6
1372,2021-10-20 11:39:23+02:00,neutron.py,nova\network,49b481ec98087351ce1366d3afb9f4a79cd16ae3,8,2,10
1373,2021-10-20 11:39:23+02:00,test_servers_resource_request.py,nova\tests,49b481ec98087351ce1366d3afb9f4a79cd16ae3,0,55,55
1374,2021-10-20 11:39:23+02:00,test_api.py,nova\tests,49b481ec98087351ce1366d3afb9f4a79cd16ae3,22,4,26
1375,2021-10-20 11:39:23+02:00,test_neutron.py,nova\tests,49b481ec98087351ce1366d3afb9f4a79cd16ae3,20,10,30
1376,2021-10-20 09:48:07+00:00,api.py,nova\compute,14e43f385e6d243b6efd11a777d082e63b66367c,6,4,10
1377,2021-10-20 09:48:07+00:00,test_api.py,nova\tests,14e43f385e6d243b6efd11a777d082e63b66367c,28,0,28
1378,2021-10-26 19:26:19+09:00,report.py,nova\scheduler,e5a34fffdf97fcda7d0abfdc9e23485479ca2c4f,26,6,32
1379,2021-10-26 19:26:19+09:00,test_nova_manage.py,nova\tests,e5a34fffdf97fcda7d0abfdc9e23485479ca2c4f,0,65,65
1380,2021-10-26 19:26:19+09:00,test_services.py,nova\tests,e5a34fffdf97fcda7d0abfdc9e23485479ca2c4f,8,17,25
1381,2021-10-26 19:26:19+09:00,test_report.py,nova\tests,e5a34fffdf97fcda7d0abfdc9e23485479ca2c4f,32,2,34
1382,2021-10-26 19:26:19+09:00,bug-1829479-cd2db21526965e6d.yaml,releasenotes\notes,e5a34fffdf97fcda7d0abfdc9e23485479ca2c4f,8,0,8
1383,2021-10-28 07:58:12+00:00,.zuul.yaml,,171138146a648d22474b7021ac730e26f03455f8,2,0,2
1384,2021-10-29 09:37:18+02:00,test_compute.py,nova\tests,be9b022bfc2c8b98d751b1f9a68ce55dd6ccf8b6,12,12,24
1385,2021-11-01 09:20:30+01:00,nova-manage.rst,doc\source,90ed7e574d06a241297b859354237350cc6eb82a,7,0,7
1386,2021-11-01 09:20:30+01:00,manage.py,nova\cmd,90ed7e574d06a241297b859354237350cc6eb82a,207,147,354
1387,2021-11-01 09:20:30+01:00,exception.py,nova,90ed7e574d06a241297b859354237350cc6eb82a,0,22,22
1388,2021-11-01 09:20:30+01:00,test_nova_manage.py,nova\tests,90ed7e574d06a241297b859354237350cc6eb82a,250,75,325
1389,2021-11-01 09:20:30+01:00,test_manage.py,nova\tests,90ed7e574d06a241297b859354237350cc6eb82a,79,53,132
1390,2021-11-01 11:26:55+00:00,post_test_hook.sh,gate,45e71fb9ceaf7fd89e63379aa65a8971b053a8b1,23,17,40
1391,2021-11-02 07:05:52+00:00,post_test_hook.sh,gate,5725297e129d3e1b5664b1bac27752d3e58ad267,17,23,40
1392,2021-11-02 10:23:58+00:00,support-port-resource-request-groups-neutron-api-extension-70a902b79f735cff.yaml,releasenotes\notes,9c2cb1fd4ff141da04c62943c5690a55e7c77f06,17,0,17
1393,2021-11-03 05:57:08-07:00,test_driver.py,nova\tests,7f81cf28bf21ad2afa98accfde3087c83b8e269b,20,13,33
1394,2021-11-03 05:57:08-07:00,driver.py,nova\virt,7f81cf28bf21ad2afa98accfde3087c83b8e269b,16,5,21
1395,2021-11-03 05:57:08-07:00,fix-ironic-compute-restart-port-attachments-3282e9ea051561d4.yaml,releasenotes\notes,7f81cf28bf21ad2afa98accfde3087c83b8e269b,11,0,11
1396,2021-11-04 17:08:58+01:00,nova.py,nova\tests,f318f822fcf6dec4c3cd9b7e5111f3e1371aa51a,17,9,26
1397,2021-11-04 17:18:54+01:00,nova.py,nova\tests,c7ccbfe403f100b5cb420fb12ac6244c4a7ae381,32,31,63
1398,2021-11-04 17:18:54+01:00,test_fixtures.py,nova\tests,c7ccbfe403f100b5cb420fb12ac6244c4a7ae381,8,8,16
1399,2021-11-05 10:10:50+08:00,test_servers.py,nova\tests,f024490e95c2bdb8072247e9907c6aa1475c80d8,1,1,2
1400,2021-11-05 11:39:17+01:00,nova.py,nova\tests,063ed41174c27c20871696f7c6dcb1eddb4310ee,13,9,22
1401,2021-11-05 11:41:27+01:00,nova.py,nova\tests,a7bccff06b871765fb87ee3e9edd9458c7f73701,12,0,12
1402,2021-11-05 11:41:27+01:00,test_migrations.py,nova\tests,a7bccff06b871765fb87ee3e9edd9458c7f73701,7,4,11
1403,2021-11-05 11:41:27+01:00,test_migrations.py,nova\tests,a7bccff06b871765fb87ee3e9edd9458c7f73701,7,4,11
1404,2021-11-05 11:41:27+01:00,test_migration.py,nova\tests,a7bccff06b871765fb87ee3e9edd9458c7f73701,4,10,14
1405,2021-11-08 12:37:27+00:00,.pre-commit-config.yaml,,f3d48000b139ec38d92da276a43a8387f76cbc89,6,0,6
1406,2021-11-08 12:37:27+00:00,feature_matrix.py,doc\ext,f3d48000b139ec38d92da276a43a8387f76cbc89,1,0,1
1407,2021-11-08 12:37:27+00:00,aggregates.py,nova\api,f3d48000b139ec38d92da276a43a8387f76cbc89,1,0,1
1408,2021-11-08 12:37:27+00:00,hosts.py,nova\api,f3d48000b139ec38d92da276a43a8387f76cbc89,1,0,1
1409,2021-11-08 12:37:27+00:00,routes.py,nova\api,f3d48000b139ec38d92da276a43a8387f76cbc89,1,0,1
1410,2021-11-08 12:37:27+00:00,server_password.py,nova\api,f3d48000b139ec38d92da276a43a8387f76cbc89,1,0,1
1411,2021-11-08 12:37:27+00:00,claims.py,nova\compute,f3d48000b139ec38d92da276a43a8387f76cbc89,1,0,1
1412,2021-11-08 12:37:27+00:00,multi_cell_list.py,nova\compute,f3d48000b139ec38d92da276a43a8387f76cbc89,2,0,2
1413,2021-11-08 12:37:27+00:00,provider_tree.py,nova\compute,f3d48000b139ec38d92da276a43a8387f76cbc89,1,0,1
1414,2021-11-08 12:37:27+00:00,cross_cell_migrate.py,nova\conductor,f3d48000b139ec38d92da276a43a8387f76cbc89,1,0,1
1415,2021-11-08 12:37:27+00:00,api.py,nova\db,f3d48000b139ec38d92da276a43a8387f76cbc89,0,1,1
1416,2021-11-08 12:37:27+00:00,filters.py,nova,f3d48000b139ec38d92da276a43a8387f76cbc89,1,0,1
1417,2021-11-08 12:37:27+00:00,model.py,nova\network,f3d48000b139ec38d92da276a43a8387f76cbc89,7,0,7
1418,2021-11-08 12:37:27+00:00,neutron.py,nova\network,f3d48000b139ec38d92da276a43a8387f76cbc89,1,0,1
1419,2021-11-08 12:37:27+00:00,devspec.py,nova\pci,f3d48000b139ec38d92da276a43a8387f76cbc89,1,0,1
1420,2021-11-08 12:37:27+00:00,host_manager.py,nova\scheduler,f3d48000b139ec38d92da276a43a8387f76cbc89,1,0,1
1421,2021-11-08 12:37:27+00:00,rbd_utils.py,nova\storage,f3d48000b139ec38d92da276a43a8387f76cbc89,2,0,2
1422,2021-11-08 12:37:27+00:00,test.py,nova,f3d48000b139ec38d92da276a43a8387f76cbc89,3,0,3
1423,2021-11-08 12:37:27+00:00,conf.py,nova\tests,f3d48000b139ec38d92da276a43a8387f76cbc89,1,0,1
1424,2021-11-08 12:37:27+00:00,libvirt.py,nova\tests,f3d48000b139ec38d92da276a43a8387f76cbc89,2,0,2
1425,2021-11-08 12:37:27+00:00,neutron.py,nova\tests,f3d48000b139ec38d92da276a43a8387f76cbc89,1,0,1
1426,2021-11-08 12:37:27+00:00,nova.py,nova\tests,f3d48000b139ec38d92da276a43a8387f76cbc89,12,0,12
1427,2021-11-08 12:37:27+00:00,policy.py,nova\tests,f3d48000b139ec38d92da276a43a8387f76cbc89,2,0,2
1428,2021-11-08 12:37:27+00:00,base.py,nova\tests,f3d48000b139ec38d92da276a43a8387f76cbc89,1,0,1
1429,2021-11-08 12:37:27+00:00,test_evacuate.py,nova\tests,f3d48000b139ec38d92da276a43a8387f76cbc89,6,0,6
1430,2021-11-08 12:37:27+00:00,test_bug_1718512.py,nova\tests,f3d48000b139ec38d92da276a43a8387f76cbc89,1,0,1
1431,2021-11-08 12:37:27+00:00,test_bug_1719730.py,nova\tests,f3d48000b139ec38d92da276a43a8387f76cbc89,1,0,1
1432,2021-11-08 12:37:27+00:00,test_bug_1746483.py,nova\tests,f3d48000b139ec38d92da276a43a8387f76cbc89,1,0,1
1433,2021-11-08 12:37:27+00:00,test_bug_1764556.py,nova\tests,f3d48000b139ec38d92da276a43a8387f76cbc89,1,0,1
1434,2021-11-08 12:37:27+00:00,test_bug_1780373.py,nova\tests,f3d48000b139ec38d92da276a43a8387f76cbc89,1,0,1
1435,2021-11-08 12:37:27+00:00,test_bug_1781286.py,nova\tests,f3d48000b139ec38d92da276a43a8387f76cbc89,2,0,2
1436,2021-11-08 12:37:27+00:00,test_bug_1839560.py,nova\tests,f3d48000b139ec38d92da276a43a8387f76cbc89,1,0,1
1437,2021-11-08 12:37:27+00:00,test_bug_1849409.py,nova\tests,f3d48000b139ec38d92da276a43a8387f76cbc89,1,0,1
1438,2021-11-08 12:37:27+00:00,test_bug_1852458.py,nova\tests,f3d48000b139ec38d92da276a43a8387f76cbc89,1,0,1
1439,2021-11-08 12:37:27+00:00,test_bug_1893284.py,nova\tests,f3d48000b139ec38d92da276a43a8387f76cbc89,1,0,1
1440,2021-11-08 12:37:27+00:00,test_bug_1894966.py,nova\tests,f3d48000b139ec38d92da276a43a8387f76cbc89,1,0,1
1441,2021-11-08 12:37:27+00:00,test_bug_1914777.py,nova\tests,f3d48000b139ec38d92da276a43a8387f76cbc89,1,0,1
1442,2021-11-08 12:37:27+00:00,test_external_networks.py,nova\tests,f3d48000b139ec38d92da276a43a8387f76cbc89,1,0,1
1443,2021-11-08 12:37:27+00:00,test_nova_manage.py,nova\tests,f3d48000b139ec38d92da276a43a8387f76cbc89,2,0,2
1444,2021-11-08 12:37:27+00:00,test_servers.py,nova\tests,f3d48000b139ec38d92da276a43a8387f76cbc89,1,0,1
1445,2021-11-08 12:37:27+00:00,test_servers_resource_request.py,nova\tests,f3d48000b139ec38d92da276a43a8387f76cbc89,2,0,2
1446,2021-11-08 12:37:27+00:00,microversions.py,nova\tests,f3d48000b139ec38d92da276a43a8387f76cbc89,1,1,2
1447,2021-11-08 12:37:27+00:00,test_attach_interfaces.py,nova\tests,f3d48000b139ec38d92da276a43a8387f76cbc89,1,0,1
1448,2021-11-08 12:37:27+00:00,test_servers.py,nova\tests,f3d48000b139ec38d92da276a43a8387f76cbc89,2,0,2
1449,2021-11-08 12:37:27+00:00,test_volumes.py,nova\tests,f3d48000b139ec38d92da276a43a8387f76cbc89,1,0,1
1450,2021-11-08 12:37:27+00:00,test_manage.py,nova\tests,f3d48000b139ec38d92da276a43a8387f76cbc89,1,0,1
1451,2021-11-08 12:37:27+00:00,eventlet_utils.py,nova\tests,f3d48000b139ec38d92da276a43a8387f76cbc89,1,0,1
1452,2021-11-08 12:37:27+00:00,test_compute.py,nova\tests,f3d48000b139ec38d92da276a43a8387f76cbc89,2,0,2
1453,2021-11-08 12:37:27+00:00,test_flavors.py,nova\tests,f3d48000b139ec38d92da276a43a8387f76cbc89,1,0,1
1454,2021-11-08 12:37:27+00:00,test_provider_config.py,nova\tests,f3d48000b139ec38d92da276a43a8387f76cbc89,1,0,1
1455,2021-11-08 12:37:27+00:00,test_conductor.py,nova\tests,f3d48000b139ec38d92da276a43a8387f76cbc89,5,0,5
1456,2021-11-08 12:37:27+00:00,test_flavor.py,nova\tests,f3d48000b139ec38d92da276a43a8387f76cbc89,1,0,1
1457,2021-11-08 12:37:27+00:00,test_report.py,nova\tests,f3d48000b139ec38d92da276a43a8387f76cbc89,1,0,1
1458,2021-11-08 12:37:27+00:00,test_hacking.py,nova\tests,f3d48000b139ec38d92da276a43a8387f76cbc89,1,0,1
1459,2021-11-08 12:37:27+00:00,test_identity.py,nova\tests,f3d48000b139ec38d92da276a43a8387f76cbc89,1,0,1
1460,2021-11-08 12:37:27+00:00,test_service.py,nova\tests,f3d48000b139ec38d92da276a43a8387f76cbc89,1,0,1
1461,2021-11-08 12:37:27+00:00,test_test.py,nova\tests,f3d48000b139ec38d92da276a43a8387f76cbc89,2,0,2
1462,2021-11-08 12:37:27+00:00,test_utils.py,nova\tests,f3d48000b139ec38d92da276a43a8387f76cbc89,2,0,2
1463,2021-11-08 12:37:27+00:00,utils.py,nova\tests,f3d48000b139ec38d92da276a43a8387f76cbc89,1,0,1
1464,2021-11-08 12:37:27+00:00,test_driver.py,nova\tests,f3d48000b139ec38d92da276a43a8387f76cbc89,3,0,3
1465,2021-11-08 12:37:27+00:00,fake_adapter.py,nova\tests,f3d48000b139ec38d92da276a43a8387f76cbc89,1,0,1
1466,2021-11-08 12:37:27+00:00,test_virt_drivers.py,nova\tests,f3d48000b139ec38d92da276a43a8387f76cbc89,1,0,1
1467,2021-11-08 12:37:27+00:00,fake.py,nova\tests,f3d48000b139ec38d92da276a43a8387f76cbc89,1,0,1
1468,2021-11-08 12:37:27+00:00,test_vmops.py,nova\tests,f3d48000b139ec38d92da276a43a8387f76cbc89,5,0,5
1469,2021-11-08 12:37:27+00:00,utils.py,nova,f3d48000b139ec38d92da276a43a8387f76cbc89,1,0,1
1470,2021-11-08 12:37:27+00:00,guestfs.py,nova\virt,f3d48000b139ec38d92da276a43a8387f76cbc89,1,0,1
1471,2021-11-08 12:37:27+00:00,fake.py,nova\virt,f3d48000b139ec38d92da276a43a8387f76cbc89,3,0,3
1472,2021-11-08 12:37:27+00:00,serialconsolehandler.py,nova\virt,f3d48000b139ec38d92da276a43a8387f76cbc89,1,0,1
1473,2021-11-08 12:37:27+00:00,driver.py,nova\virt,f3d48000b139ec38d92da276a43a8387f76cbc89,1,0,1
1474,2021-11-08 12:37:27+00:00,config.py,nova\virt,f3d48000b139ec38d92da276a43a8387f76cbc89,1,0,1
1475,2021-11-08 12:37:27+00:00,driver.py,nova\virt,f3d48000b139ec38d92da276a43a8387f76cbc89,1,1,2
1476,2021-11-08 12:37:27+00:00,event.py,nova\virt,f3d48000b139ec38d92da276a43a8387f76cbc89,1,0,1
1477,2021-11-08 12:37:27+00:00,imagebackend.py,nova\virt,f3d48000b139ec38d92da276a43a8387f76cbc89,1,0,1
1478,2021-11-08 12:37:27+00:00,iser.py,nova\virt,f3d48000b139ec38d92da276a43a8387f76cbc89,1,0,1
1479,2021-11-08 12:37:27+00:00,mount.py,nova\virt,f3d48000b139ec38d92da276a43a8387f76cbc89,1,0,1
1480,2021-11-08 12:37:27+00:00,net.py,nova\virt,f3d48000b139ec38d92da276a43a8387f76cbc89,1,0,1
1481,2021-11-08 12:37:27+00:00,scaleio.py,nova\virt,f3d48000b139ec38d92da276a43a8387f76cbc89,1,0,1
1482,2021-11-08 12:37:27+00:00,volume.py,nova\virt,f3d48000b139ec38d92da276a43a8387f76cbc89,3,0,3
1483,2021-11-08 12:37:27+00:00,driver.py,nova\virt,f3d48000b139ec38d92da276a43a8387f76cbc89,1,0,1
1484,2021-11-08 12:37:27+00:00,host.py,nova\virt,f3d48000b139ec38d92da276a43a8387f76cbc89,1,0,1
1485,2021-11-08 12:37:27+00:00,cinder.py,nova\volume,f3d48000b139ec38d92da276a43a8387f76cbc89,5,0,5
1486,2021-11-08 12:37:27+00:00,weights.py,nova,f3d48000b139ec38d92da276a43a8387f76cbc89,1,0,1
1487,2021-11-08 12:37:27+00:00,tox.ini,,f3d48000b139ec38d92da276a43a8387f76cbc89,15,0,15
